OBJECTID,GbCity,City_CH,City_EN,A100008_00,A100008_10,A100009_00,A100009_10,A101001_00,A101001_10,A101002_00,A101002_10,A101003_00,A101003_10,A101004_00,A101004_10,A101005_00,A101005_10,A101006_00,A101006_10,A103001_00,A103001_10,A104001_00,A104001_10,A104004_00,A104004_10,A104007_00,A104007_10,A104010_00,A104010_10,A105004_00,A105004_10,A105007_00,A105007_10,GbProv,Prov_CH,Prov_EN,Shape_Leng,Shape_Area,count
"101","3401",合肥市,Hefei,1964008,3887273,2503376,1815193,1280983,1993567,1234075,1832390,46908,161177,4467384,5702466,2345534,2982490,2121850,2719976,4033712,5019461,680004,1946902,98441,471186,300033,1279465,39103,196251,3031831,3110658,1409572,2523903,34,安徽省,Anhui,4.96984460942,0.71449946628,"2"
"1","1101",北京市辖区,Beijing (Districts),9876661,16446857,1632934,2380405,3782969,7058426,3483627,6394889,299342,663537,11509595,18827262,6020903,9727900,5488692,9099362,7800073,11845658,4265700,10288947,0,1498350,81874,1854807,2261763,6935790,3848817,6953411,7539608,11757102,11,北京市,Beijing,5.60512254654,0.8532664582,"1"
"1","1101",北京市辖区,Beijing (Districts),9876661,16446857,1632934,2380405,3782969,7058426,3483627,6394889,299342,663537,11509595,18827262,6020903,9727900,5488692,9099362,7800073,11845658,4265700,10288947,0,1498350,81874,1854807,2261763,6935790,3848817,6953411,7539608,11757102,11,北京市,Beijing,5.60512254654,0.8532664582,"1"
"1","1101",北京市辖区,Beijing (Districts),9876661,16446857,1632934,2380405,3782969,7058426,3483627,6394889,299342,663537,11509595,18827262,6020903,9727900,5488692,9099362,7800073,11845658,4265700,10288947,0,1498350,81874,1854807,2261763,6935790,3848817,6953411,7539608,11757102,11,北京市,Beijing,5.60512254654,0.8532664582,"1"
"238","5001",重庆市辖区,Chongqing (Districts),6174429,10778685,3517472,4914805,3098632,5595202,2975290,5373542,123342,221660,9691901,15693490,5013398,7947973,4678503,7745517,8416380,15612594,1708409,4170553,6743,1615666,365116,1730140,281323,824747,5694063,8482335,3953917,7115713,50,重庆市,Chongqing,13.4358090654,1.39148848564,"2"
"239","5002",重庆市辖县,Chongqing (Counties),3921083,4517118,16899779,8635562,6219567,4677357,6166268,4627423,53299,49934,20820862,13152680,10828031,6660897,9992831,6491783,21422714,17537251,916693,1270223,664242,1020976,116369,128800,121836,120447,18118972,10235171,2621745,2783269,50,重庆市,Chongqing,34.3742717579,6.32449733997,"1"
"238","5001",重庆市辖区,Chongqing (Districts),6174429,10778685,3517472,4914805,3098632,5595202,2975290,5373542,123342,221660,9691901,15693490,5013398,7947973,4678503,7745517,8416380,15612594,1708409,4170553,6743,1615666,365116,1730140,281323,824747,5694063,8482335,3953917,7115713,50,重庆市,Chongqing,13.4358090654,1.39148848564,"2"
"238","5001",重庆市辖区,Chongqing (Districts),6174429,10778685,3517472,4914805,3098632,5595202,2975290,5373542,123342,221660,9691901,15693490,5013398,7947973,4678503,7745517,8416380,15612594,1708409,4170553,6743,1615666,365116,1730140,281323,824747,5694063,8482335,3953917,7115713,50,重庆市,Chongqing,13.4358090654,1.39148848564,"1"
"238","5001",重庆市辖区,Chongqing (Districts),6174429,10778685,3517472,4914805,3098632,5595202,2975290,5373542,123342,221660,9691901,15693490,5013398,7947973,4678503,7745517,8416380,15612594,1708409,4170553,6743,1615666,365116,1730140,281323,824747,5694063,8482335,3953917,7115713,50,重庆市,Chongqing,13.4358090654,1.39148848564,"1"
"238","5001",重庆市辖区,Chongqing (Districts),6174429,10778685,3517472,4914805,3098632,5595202,2975290,5373542,123342,221660,9691901,15693490,5013398,7947973,4678503,7745517,8416380,15612594,1708409,4170553,6743,1615666,365116,1730140,281323,824747,5694063,8482335,3953917,7115713,50,重庆市,Chongqing,13.4358090654,1.39148848564,"5"
"118","3501",福州市,Fuzhou,3359051,4408076,3026964,2707293,1777855,2324249,1668974,2177300,108881,146949,6386015,7115369,3290152,3630096,3095863,3485273,5336764,6462516,1432946,2374956,233745,612468,436072,972824,395482,789664,4552056,4770466,1676888,2238010,35,福建省,Fujian,16.4514728158,1.03347078396,"2"
"303","6201",兰州市,Lanzhou,2070949,2758558,1071574,857605,919090,1200381,868254,1112369,50836,88012,3142523,3616163,1635825,1849819,1506698,1766344,2651559,3214127,651028,1155324,35375,372634,213875,576533,104967,206157,1487983,1487979,1625895,2090542,62,甘肃省,Gansu,7.01463665924,1.33027870042,"1"
"314","6228",庆阳地区,Qingyangdiqu,316923,522780,2104037,1688411,580511,611917,568168,595445,12343,16472,2420960,2211191,1251582,1122421,1169378,1088770,2473845,2600422,55047,224441,30828,135982,15473,71643,7108,16816,2153239,1896328,263586,293042,62,甘肃省,Gansu,9.67693591401,2.72096062799,"1"
"200","4401",广州市,Guangzhou,8090976,10641408,1851046,2060540,2820647,4330407,2374086,3785278,446561,545129,9942022,12701948,5175742,6639745,4766280,6062203,6096252,8077303,4281782,6147448,70275,729256,1162909,2415676,2149978,3002516,5232957,6144111,4582706,6492524,44,广东省,Guangdong,5.86459678617,0.62169026726,"1"
"219","4452",揭阳市,Jieyang,1985790,2783996,3251615,3100351,1072602,1197952,1053510,1178425,19092,19527,5237405,5884347,2684258,2994460,2553147,2889887,5195946,6585347,265619,281956,87375,163513,21390,34839,133652,83604,4414895,4849375,729488,932261,44,广东省,Guangdong,5.03610908783,0.46180141391,"1"
"204","4405",汕头市,Shantou,3129771,3689655,1541508,1699673,997057,1207760,965828,1169534,31229,38226,4671279,5389328,2356424,2703834,2314855,2685494,4321118,5261879,475120,768999,58286,252845,88588,194730,155342,321424,3191936,3703793,1378422,1548726,44,广东省,Guangdong,4.67692121826,0.18559283628,"1"
"202","4403",深圳市,Shenzhen,6480340,10358381,528491,0,1969621,4535427,1188738,3587005,780883,948422,7008831,10358381,3454392,5613545,3554439,4744836,997996,2510145,6070670,8514958,9087,236683,1792934,2482178,4055605,5796097,4992729,6627292,1991327,3641553,44,广东省,Guangdong,3.28932552962,0.1633091003,"3"
"207","4408",湛江市,Zhanjiang,2337362,2565740,3733340,4429092,1437359,1828581,1417168,1784361,20191,44220,6070702,6994832,3202665,3651062,2868037,3343770,6306558,7768143,440788,741779,153668,432136,72687,235825,80303,73818,4680751,5172137,1294235,1644839,44,广东省,Guangdong,16.1632741845,1.05796754594,"1"
"217","4420",中山市,Zhongshan,1434251,2740994,929071,380281,556985,1095857,433293,915156,123692,180701,2363322,3121275,1175587,1656632,1187735,1464643,1303138,1498598,1099304,1761501,54443,109035,183591,328937,861270,1323529,1878836,2466087,471635,634965,44,广东省,Guangdong,1.80664304942,0.14329327946,"1"
"225","4505",北海市,Beihai,651401,727918,771835,811333,358205,420119,350932,407284,7273,12835,1423236,1539251,752484,800856,670752,738395,1351370,1617453,166075,264713,24009,105506,62897,101082,30091,58125,1028614,1056225,387621,460768,45,广西省,Guangxi,5.45626434722,0.29111525126,"1"
"230","4521",南宁地区,Nanningdiqu,884522,554578,3955014,1439707,1269617,593044,1260574,582867,9043,10177,4839536,1994285,2550567,1043139,2288969,951146,5357807,2347699,180039,196613,110994,100019,51722,72627,17323,23967,4209009,1653540,622221,305309,45,广西省,Guangxi,15.6460086067,2.61233737315,"1"
"223","4503",桂林市,Guilin,1256036,1840230,3358634,2907733,1336552,1487410,1309925,1448445,26627,38965,4614670,4747963,2437613,2456581,2177057,2291382,4594053,4988397,370620,761757,55801,267825,159317,348755,75788,145177,3635429,3610283,964819,1079300,45,广西省,Guangxi,9.47042066443,2.47963762569,"5"
"222","4502",柳州市,Liuzhou,1255841,2166882,843999,1591822,603431,1156540,573829,1116423,29602,40117,2099840,3758704,1102934,1960125,996906,1798579,1678357,3554441,569760,994176,43730,278431,325598,590517,76352,125228,1155578,2444617,933447,1263540,45,广西省,Guangxi,4.09173922016,0.46862738076,"2"
"221","4501",南宁市,Nanning,1785749,3578333,1435941,3080409,918964,2147950,856981,2040955,61983,106995,3221690,6658742,1706813,3452717,1514877,3206025,2761932,6865488,677794,1664205,36681,382004,394670,1060885,68492,221316,1926866,4667886,1279613,1899577,45,广西省,Guangxi,5.54576262612,0.86474362308,"9"
"227","4507",钦州市,Qinzhou,631792,903521,2262615,2176200,705071,837487,699917,824829,5154,12658,2894407,3079721,1588034,1638285,1306373,1441436,3139923,3791093,133095,282337,41534,169674,29371,74981,10712,37682,2581480,2624585,302716,361133,45,广西省,Guangxi,8.11998893987,0.9269596055,"1"
"224","4504",梧州市,Wuzhou,841034,1238723,1955053,1643477,702803,803722,695051,790220,7752,13502,2796087,2882200,1478118,1494853,1317969,1387347,2794393,3273292,158290,275369,34688,130821,52400,113753,18378,30795,2278363,2226388,510881,558140,45,广西省,Guangxi,7.88659511712,1.10896343433,"1"
"229","4509",玉林市,Yulin,1337125,2172918,3749090,3314450,1276139,1524260,1260365,1505095,15774,19165,5086215,5487368,2714479,2857653,2371736,2629715,5552794,6712331,159291,436552,59778,291384,57405,107786,24887,37382,4544382,4750082,536358,586498,45,广西省,Guangxi,7.0572031322,1.12796611115,"2"
"261","5201",贵阳市,Guiyang,2274712,2932285,1443737,1390326,1109413,1434249,1064903,1370555,44510,63694,3718449,4322611,1954819,2221896,1763630,2100715,3076270,3735364,928437,1513342,49095,336108,414544,904609,169188,272625,2087101,2340485,1570267,1898515,52,贵州省,Guizhou,5.44286664802,0.72957377261,"2"
"10","1306",保定市,Baoding,2419839,4340339,8051284,6854043,2760205,3108674,2708057,3039158,52148,69516,10471123,11194382,5302641,5650947,5168482,5543435,9921763,11280217,746244,1117253,269457,546788,170532,362953,160137,207512,8961843,9385546,1485271,1744756,13,河北省,Hebei,8.60900503627,2.31884350192,"3"
"13","1309",沧州市,Cangzhou,1435714,2912542,5203787,4221520,1827396,2083216,1803085,2056649,24311,26567,6639501,7134062,3380277,3647202,3259224,3486860,6342024,7161336,380411,592100,136701,347392,81844,143711,86099,100997,5568516,5851526,1057420,1203641,13,河北省,Hebei,7.91448166567,1.45254288765,"1"
"12","1308",承德市,Chengde,834121,1343103,2490000,2130098,979006,1046297,964964,1024783,14042,21514,3324121,3473201,1718138,1782914,1605983,1690287,3331749,3716445,201188,440390,84048,276477,44454,114161,16923,49752,2683646,2724709,630807,727807,13,河北省,Hebei,13.6357645659,4.25741578577,"1"
"8","1304",邯郸市,Handan,1964038,3985686,6422776,5188997,2102555,2389789,2055109,2359454,47446,30335,8386814,9174683,4266539,4617598,4120275,4557085,8049006,9376651,440310,718207,108644,421511,119577,250943,61095,45753,7011600,7352216,1357411,1676941,13,河北省,Hebei,6.45672993926,1.21455724337,"1"
"14","1310",廊坊市,Langfang,1124617,2115141,2708827,2243698,1006490,1250396,983505,1204601,22985,45795,3833444,4358839,1950254,2233100,1883190,2125739,3594464,4132357,285272,684626,64178,248082,49374,116890,121785,319654,3199570,3391063,625534,917660,13,河北省,Hebei,6.24731446224,0.66986874138,"5"
"5","1301",石家庄市,Shijiazhuang,3238859,5145133,6002327,5018655,2431040,2795346,2351008,2720331,80032,75015,9241186,10163788,4691030,5087913,4550156,5075875,8377647,9810454,1020503,1542493,185959,633436,299955,707898,168954,201159,7109438,7070053,2113762,3063344,13,河北省,Hebei,6.54598339391,1.44466958468,"6"
"9","1305",邢台市,Xingtai,1331530,2842785,5314236,4261318,1689376,1941607,1659042,1916890,30334,24717,6645766,7104103,3374805,3606588,3270961,3497515,6369263,7222603,337861,515579,112301,309577,89771,173341,38608,32661,5768490,6115163,868639,932642,13,河北省,Hebei,6.13577259387,1.26640819538,"3"
"11","1307",张家口市,Zhangjiakou,1218144,1962450,2972891,2383035,1394030,1504873,1374172,1481690,19858,23183,4191035,4345485,2162852,2225425,2028183,2120060,3925234,4637341,511634,941060,154964,534186,135477,322109,50810,84765,3147579,3115745,1027670,1186796,13,河北省,Hebei,12.3996370852,3.92034423133,"2"
"159","4105",安阳市,Anyang,1324381,1985666,3836725,3187522,1370845,1503594,1353012,1486536,17833,17058,5161106,5173188,2616008,2502912,2545098,2670276,4947435,5682720,313407,475407,67215,266307,92564,179906,29401,29194,4259492,3985397,879812,1065827,41,河南省,Henan,6.82958892047,0.72431968825,"2"
"156","4102",开封市,Kaifeng,881176,1658481,3705357,3018002,1165201,1258762,1153644,1241002,11557,17760,4586533,4676483,2340547,2370764,2245986,2305719,4506833,5034485,197187,326967,35517,156401,47592,154198,15935,16368,3765083,3863163,811303,795513,41,河南省,Henan,4.88153680584,0.61463560733,"3"
"157","4103",洛阳市,Luoyang,1870406,2888355,4357259,3661586,1656657,1843466,1621298,1806277,35359,37189,6227665,6549941,3206614,3306567,3021051,3243374,5964037,6803931,496335,845615,116115,395312,141557,390495,47035,59808,4754556,4831096,1431179,1650244,41,河南省,Henan,7.28591216898,1.48022294875,"1"
"165","4111",漯河市,Luohe,533706,994586,1728698,1549680,628398,674464,619414,662051,8984,12413,2262404,2544266,1156563,1299682,1105841,1244584,2284578,2712381,124281,188830,32325,107764,41304,74469,6997,6597,1820248,1972819,433219,564420,41,河南省,Henan,2.9972167267,0.25722579406,"1"
"167","4113",南阳市,Nanyang,1930773,3333599,7646998,6930061,2794458,2797286,2765001,2747972,29457,49314,9577771,10263660,5006444,5280744,4571327,4982916,9920708,11574387,408040,876767,122810,673541,120151,176672,23297,26554,8262133,8727250,1289804,1437677,41,河南省,Henan,9.81205078929,2.55561647843,"3"
"168","4114",商丘市,Shangqiu,1023886,2171557,6729958,5191418,2074220,2217939,2065041,2198804,9179,19135,7753844,7362975,3993289,3683893,3760555,3679082,7845853,8853505,160156,322939,59667,237152,28413,70276,12155,15511,6918012,6273513,811555,1043185,41,河南省,Henan,6.43177926955,1.04789442811,"2"
"161","4107",新乡市,Xinxiang,1274302,2328848,4133131,3379343,1345629,1451623,1327765,1435177,17864,16446,5407433,5708191,2750596,2873482,2656837,2834709,5184887,5894761,310558,447945,105004,236168,77210,191375,23750,20402,4399882,4685469,981671,976218,41,河南省,Henan,5.29939431397,0.817335564,"2"
"155","4101",郑州市,Zhengzhou,3664517,5477495,2992242,3149594,1831813,2606648,1733410,2436665,98403,169983,6656759,8627089,3448942,4422318,3207817,4204771,5753046,7309348,1154627,2704542,147444,709306,476824,1749758,141050,245478,4428338,5692014,2183913,2879871,41,河南省,Henan,4.87210344418,0.73924190487,"1"
"164","4110",许昌市,Xuchang,839419,1656644,3284667,2650844,1124036,1175451,1111399,1156026,12637,19425,4124086,4307488,2133494,2206634,1990592,2100854,4163108,4767581,189784,466982,59520,318574,63895,118192,11436,30216,3511857,3208134,597565,1070090,41,河南省,Henan,4.25084548607,0.48799336475,"2"
"155","4101",郑州市,Zhengzhou,3664517,5477495,2992242,3149594,1831813,2606648,1733410,2436665,98403,169983,6656759,8627089,3448942,4422318,3207817,4204771,5753046,7309348,1154627,2704542,147444,709306,476824,1749758,141050,245478,4428338,5692014,2183913,2879871,41,河南省,Henan,4.87210344418,0.73924190487,"43"
"170","4116",周口市,Zhoukou,1264706,2637555,8476577,6316238,2501231,2529876,2492569,2505505,8662,24371,9741283,8953793,5056050,4425662,4685233,4528131,10113125,11143370,138505,392062,73654,305757,31199,76893,6156,9412,8878583,7947515,847584,941579,41,河南省,Henan,6.55090942969,1.16906581965,"1"
"171","4117",驻马店市,Zhumadian,902866,2130450,6549886,5100784,2055884,2076185,2046616,2056880,9268,19305,7452752,7231234,3847370,3641356,3605382,3589878,7774667,8823380,176507,506119,61196,414653,53774,75939,10068,15527,6692716,6128931,730543,1061472,41,河南省,Henan,7.48788564339,1.45587846096,"5"
"177","4207",鄂州市,Ezhou,551876,607739,471409,440929,267695,300204,261852,294451,5843,5753,1023285,1048668,533940,551366,489345,497302,943142,1082655,106436,126680,3381,80377,21777,36617,4502,9686,730051,669590,283928,366079,42,湖北省,Hubei,2.37534515164,0.15296959224,"3"
"178","4208",荆门市,Jingmen,1257509,1307473,1713339,1566214,806252,835995,781857,818037,24395,17958,2970848,2873687,1529692,1461065,1441156,1412622,2781911,2994476,262475,388161,81914,194157,69530,156943,33975,37061,2221253,2086606,736871,772053,42,湖北省,Hubei,5.98829763847,1.16684433789,"1"
"183","4213",随州市,Suizhou,856047,827316,1628641,1334906,654002,630362,628682,622578,25320,7784,2484688,2162222,1277543,1096250,1207145,1065972,2401109,2571219,106268,194790,33318,151061,7464,32258,4591,11471,2042976,1737371,434703,409243,42,湖北省,Hubei,5.49039611203,0.91408590294,"1"
"172","4201",武汉市,Wuhan,6787482,7541527,1525218,2243861,2448665,3246053,2288097,2932764,160568,313289,8312700,9785388,4306729,5033091,4005971,4752297,6673376,8383650,2205600,3835009,20292,1069207,734565,2239768,250079,526034,3739816,4057820,4521813,5662825,42,湖北省,Hubei,5.92444597206,0.80026809424,"14"
"182","4212",咸宁市,Xianning,1009571,1051470,1691107,1411113,680893,708039,659982,693808,20911,14231,2700678,2462583,1411508,1264784,1289170,1197799,2643805,2964114,202271,338978,102225,258935,29477,56367,17194,23676,1993949,1752165,696367,655840,42,湖北省,Hubei,5.96745429903,0.90667037956,"3"
"176","4206",襄樊市,Xiangfan,2428857,2752370,3229866,2747937,1557403,1599059,1506314,1572191,51089,26868,5658723,5500307,2903797,2783478,2754926,2716829,5179888,5923797,594197,779460,215551,498705,169646,228285,40178,52470,4132247,3899492,1503125,1554371,42,湖北省,Hubei,8.06974454965,1.88092602667,"2"
"179","4209",孝感市,Xiaogan,1548589,2214781,3443948,2599761,1267135,1377391,1242362,1348768,24773,28623,4992537,4814542,2603441,2479051,2389096,2335491,4954935,5246783,163872,480060,82977,368350,38019,82742,13076,28968,4124687,3682882,854160,1093329,42,湖北省,Hubei,6.2118743097,0.8398733091,"1"
"192","4307",常德市,Changde,1526358,2221292,4214517,3493331,1692934,1731463,1668791,1702266,24143,29197,5740875,5714623,2964217,2881031,2776658,2833592,5624316,6225913,387918,550003,160089,365409,82471,151820,19200,32774,4636015,4250717,1078465,1431364,43,湖南省,Hunan,8.75955647876,1.69656706385,"1"
"195","4310",郴州市,Chenzhou,901992,1911405,3422820,2672126,1247988,1362727,1232524,1344046,15464,18681,4324812,4583531,2263545,2375678,2061267,2207853,4173790,5012400,285369,587408,111640,328702,83087,198923,19979,59783,3532854,3512433,777209,935241,43,湖南省,Hunan,10.2145064537,1.7475701632,"1"
"189","4304",衡阳市,Hengyang,1811187,3180864,4973704,3967480,1901777,1983583,1864647,1942855,37130,40728,6784891,7148344,3583138,3707589,3201753,3440755,6791433,7902022,398776,749818,109347,421204,127578,278233,27584,50381,5408058,5423566,1352852,1664578,43,湖南省,Hunan,7.85684714159,1.39470858525,"1"
"189","4304",衡阳市,Hengyang,1811187,3180864,4973704,3967480,1901777,1983583,1864647,1942855,37130,40728,6784891,7148344,3583138,3707589,3201753,3440755,6791433,7902022,398776,749818,109347,421204,127578,278233,27584,50381,5408058,5423566,1352852,1664578,43,湖南省,Hunan,7.85684714159,1.39470858525,"1"
"197","4312",怀化市,Huaihua,1064136,1711423,3575602,3030250,1294390,1379302,1279357,1359814,15033,19488,4639738,4741673,2416643,2447003,2223095,2294670,4600407,5092480,290344,548360,137323,312116,91824,167129,21683,69115,3829570,3782283,799721,936854,43,湖南省,Hunan,14.4546759243,2.5168621889,"2"
"186","4301",长沙市,Changsha,2743826,4765918,3394893,2275034,1806981,2226693,1705895,2072002,101086,154691,6138719,7040952,3185555,3579624,2953164,3461328,5483204,6512131,901406,1978314,100445,558309,439362,1188798,80116,231207,4172678,4555530,1945483,2452919,43,湖南省,Hunan,7.67681347122,1.08218768007,"1"
"190","4305",邵阳市,Shaoyang,1340260,2322211,5623359,4749524,1954334,1964747,1933227,1950605,21107,14142,6963619,7071735,3645707,3671019,3317912,3400716,6983502,7927558,274418,365935,124934,250810,47111,93380,11382,21745,6009231,5843473,942554,1137483,43,湖南省,Hunan,8.96116755353,1.89600831607,"1"
"188","4303",湘潭市,Xiangtan,959924,1379021,1712145,1373150,795460,830337,775025,813460,20435,16877,2672069,2752171,1374428,1403112,1297641,1349059,2633147,2888294,253284,451965,55996,270761,83943,146101,17265,35103,1928418,1856913,734588,877712,43,湖南省,Hunan,4.62842686602,0.46295352351,"4"
"196","4311",永州市,Yongzhou,1162257,1837863,4204849,3356412,1463041,1440722,1450572,1428723,12469,11999,5367106,5194275,2843142,2705361,2523964,2488914,5502751,6097782,178115,399472,84002,295993,32061,80038,11910,23441,4577114,4296115,779440,841645,43,湖南省,Hunan,10.0844707795,2.01127113965,"2"
"191","4306",岳阳市,Yueyang,1558954,2519587,3452462,2956497,1433069,1529904,1411611,1504946,21458,24958,5011416,5476084,2618697,2833087,2392719,2642997,4828906,5648840,430753,553315,124897,376754,140261,124180,52079,52381,4022896,3969130,958066,1462032,43,湖南省,Hunan,8.90766441635,1.37393719893,"1"
"186","4301",长沙市,Changsha,2743826,4765918,3394893,2275034,1806981,2226693,1705895,2072002,101086,154691,6138719,7040952,3185555,3579624,2953164,3461328,5483204,6512131,901406,1978314,100445,558309,439362,1188798,80116,231207,4172678,4555530,1945483,2452919,43,湖南省,Hunan,7.67681347122,1.08218768007,"11"
"187","4302",株洲市,Zhuzhou,1367609,2178616,2214211,1678484,1020476,1088582,994177,1064120,26299,24462,3581820,3857100,1844915,1969989,1736905,1887111,3483434,3898444,349237,605203,89994,278920,139845,243175,48162,83108,2664168,2787853,909579,1042404,43,湖南省,Hunan,7.29427045076,1.02550909492,"7"
"55","2203",四平市,Siping,1178496,1407104,2113830,1978052,962984,1047574,954467,1036741,8517,10833,3292326,3385156,1684139,1715479,1608187,1669677,3187708,3380732,164463,278703,69539,207882,25629,53904,17079,16917,2187992,2221282,1087956,1152929,22,吉林省,Jilin,8.71622229148,1.60024571798,"1"
"80","3204",常州市,Changzhou,2037352,2900970,1738918,1691461,1224682,1631663,1166071,1553508,58611,78155,3776270,4592431,1904542,2341100,1871728,2251331,3148577,3605655,894560,1669787,121317,243220,266695,619899,330704,806668,2500599,3054586,1230222,1507345,32,江苏省,Jiangsu,4.57942812546,0.41342321997,"1"
"83","3207",连云港市,Lianyungang,1280345,2273872,3289568,2119610,1210470,1312471,1191434,1286515,19036,25956,4569913,4393482,2371943,2225490,2197970,2167992,4408610,4982954,273499,529029,91086,258736,71364,213254,28744,57039,3474844,2876438,1045519,1479747,32,江苏省,Jiangsu,5.86507512183,0.72723621712,"1"
"77","3201",南京市,Nanjing,4355280,6238186,1770885,1765558,2004390,2645825,1885221,2369147,119169,276678,6126165,8003744,3210542,4142501,2915623,3861243,5086775,6364200,1398218,2742657,94664,494558,405933,1380646,389814,867453,2785606,3176261,3288876,4797251,32,江苏省,Jiangsu,5.98260535261,0.62915092726,"1"
"82","3206",南通市,Nantong,2519791,4064388,4993128,3219234,2557062,2659552,2513094,2588400,43968,71152,7512919,7283622,3594099,3443092,3918820,3840530,7519634,7659001,691603,1017157,251700,382239,147681,305079,141464,329839,5928749,5449945,1532548,1801259,32,江苏省,Jiangsu,5.77978530463,0.81681066621,"1"
"81","3205",苏州市,Suzhou,3877281,7329514,2914958,3130376,2086704,3348834,1949249,2922797,137455,426037,6792239,10459890,3364085,5334473,3428154,5125417,5502349,6377730,1513048,4931025,179428,409355,443554,1367532,711091,3154138,4316617,6667714,2434173,3769447,32,江苏省,Jiangsu,5.3718895273,0.79976511584,"2"
"89","3213",宿迁市,Suqian,1289682,2278812,3771894,2440366,1262454,1322388,1253271,1304062,9183,18326,5061576,4719178,2607175,2380357,2454401,2338821,4987655,5550042,182260,395957,95746,279687,41400,79352,15680,36918,3888716,3633334,1146942,1023986,32,江苏省,Jiangsu,5.38845580323,0.83558059567,"1"
"88","3212",泰州市,Taizhou,1886081,2570087,2899678,2048850,1511264,1555643,1495752,1527619,15512,28024,4785759,4618937,2403310,2308945,2382449,2309992,4798770,5011125,365131,653565,171194,340074,68705,163417,64661,150074,3569774,3360704,1172963,1220436,32,江苏省,Jiangsu,4.9980112158,0.55557204147,"1"
"78","3202",无锡市,Wuxi,2962969,4481903,2123617,1892496,1613022,2201293,1534611,2050680,78411,150613,5086586,6374399,2589585,3306295,2497001,3068104,4127977,4673509,1189100,2474853,161467,333654,372145,850386,484500,1290813,3286843,3998375,1758613,2354367,32,江苏省,Jiangsu,4.39469547849,0.44105383332,"1"
"86","3210",扬州市,Yangzhou,1959025,2530918,2629529,1929148,1391316,1443832,1342103,1402301,49213,41531,4588554,4460066,2283655,2196448,2304899,2263618,4359888,4631225,551708,742234,176258,308496,175474,293142,90787,140596,3204167,3079602,1333078,1349415,32,江苏省,Jiangsu,4.8847426635,0.63606008821,"1"
"87","3211",镇江市,Zhenjiang,1434466,1929892,1410390,1184213,910277,1009905,874022,974874,36255,35031,2844856,3114105,1448120,1595880,1396736,1518225,2485687,2719759,508438,838730,124759,270991,145325,281841,123091,285898,1880749,2029695,921612,1065487,32,江苏省,Jiangsu,3.94120723214,0.36526962864,"2"
"133","3607",赣州市,Ganzhou,1518184,3141592,5878689,5226855,1910700,2129788,1823897,2079574,86803,50214,7396873,8368447,3785456,4257863,3611417,4110584,7540925,9132828,532657,887388,317583,671396,106948,146962,36449,69030,6074242,6539838,1240979,1679224,36,江西省,Jiangxi,12.9517053285,3.54776302622,"2"
"128","3602",景德镇市,Jingdezhen,666135,893938,787232,693539,386848,439655,378727,431567,8121,8088,1453367,1587477,754574,826128,698793,761349,1344674,1569721,170330,203044,29980,101366,58226,75891,11071,25787,931831,986260,504935,587957,36,江西省,Jiangxi,4.31041574644,0.48854393884,"3"
"127","3601",南昌市,Nanchang,2115437,3313235,2216231,1729331,1130281,1404201,1088664,1299903,41617,104298,4331668,5042566,2261789,2633846,2069879,2408720,3775664,4986832,822589,1399073,116170,482796,283202,721952,47182,194325,2522224,2531446,1724346,2422044,36,江西省,Jiangxi,4.65675788055,0.68154070193,"5"
"129","3603",萍乡市,Pingxiang,675093,1097352,1049639,757163,435547,487720,425692,481518,9855,6202,1724732,1854515,891787,938753,832945,915762,1701274,1909089,125061,189705,34389,108684,18966,55087,10908,25934,1269534,1205058,443238,613384,36,江西省,Jiangxi,3.67215484821,0.34676201401,"2"
"131","3605",新余市,Xinyu,457260,701198,614560,437676,322413,355063,309092,344441,13321,10622,1071820,1138874,563266,598003,508554,540871,1010279,1162584,115509,279203,17497,189294,29441,48015,11221,41894,746003,741170,323595,394034,36,江西省,Jiangxi,2.94874547025,0.29296528871,"1"
"135","3609",宜春市,Yichun,1260043,1928705,3819749,3490886,1318127,1450918,1292888,1423419,25239,27499,5079792,5419591,2666525,2824148,2413267,2595443,4938853,5630085,343896,484279,177666,369447,48506,67428,26388,47404,3937324,4034822,1107272,1277622,36,江西省,Jiangxi,9.51117920225,1.71742411559,"1"
"40","2102",大连市,Dalian,3734718,4979140,2158974,1711292,1901141,2436574,1844255,2324622,56886,111952,5893692,6690432,2990856,3375745,2902836,3314687,4891194,5852317,1311383,2191176,167899,544023,230065,863325,404533,783828,3017795,2909503,2843835,3770407,21,辽宁省,Liaoning,18.5315459699,1.34143924895,"3"
"39","2101",沈阳市,Shenyang,5066072,6247700,2137645,1858471,2307909,2946502,2258706,2839413,49203,107089,7203717,8106171,3673572,4095172,3530145,4010999,5810170,7183908,1599928,2415071,107367,727862,281321,1254594,239009,432615,2758996,2950578,4392829,5133802,21,辽宁省,Liaoning,8.22157863133,1.39817238648,"6"
"27","1501",呼和浩特市,Huhehaote,1222175,1790682,1170720,1075933,751437,1007779,722377,952872,29060,54907,2392895,2866615,1244736,1462776,1148159,1403839,1869943,2236913,683777,1393517,65405,292426,304671,931211,54442,169880,1350722,1630397,997447,1213853,15,内蒙古,Neimenggu,7.24347015108,1.82350733554,"1"
"325","6401",银川市,Yinchuan,654261,1445405,523352,547683,365675,680885,351373,640621,14302,40264,1177613,1993088,605377,1030563,572236,962525,900716,1560669,325421,762828,16525,185555,91828,325627,111088,251646,571949,865640,587175,1109973,64,宁夏省,Ningxia,2.6413270996,0.36562992219,"1"
"138","3701",济南市,Jinan,3334482,4392922,2587409,2421062,1753180,2112900,1684787,2012581,68393,100319,5921891,6813984,3002142,3423904,2919749,3390080,5353970,6064821,773253,1747126,131142,521074,211114,975221,89998,250831,3703928,4131264,2199068,2655018,37,山东省,Shandong,6.64673646771,0.79807803402,"2"
"139","3702",青岛市,Qingdao,4283674,5735439,3210520,2979648,2416231,2966355,2326998,2824283,89233,142072,7494194,8715087,3757411,4391744,3736783,4323343,6593541,7651797,1256686,2477318,279286,683716,327027,1199104,214056,594498,5112978,5597181,2349632,3083834,37,山东省,Shandong,11.3640891116,1.08881630085,"7"
"143","3706",烟台市,Yantai,3036902,3851425,3598833,3116777,2284667,2540718,2220279,2456755,64388,83963,6635735,6968202,3350625,3522519,3285110,3445683,6024005,6517820,858337,1364960,302042,589902,186093,467628,154101,307430,5126105,5065880,1486339,1884621,37,山东省,Shandong,11.2135668803,1.37331218274,"1"
"16","1401",太原市,Taiyuan,2755726,3467987,588666,733605,977280,1395184,925336,1296291,51944,98893,3344392,4201592,1741413,2151719,1602979,2049873,2639191,3650340,834113,1549967,48954,447793,221284,818384,156820,283790,1293216,1593136,2018799,2577568,14,山西省,Shanxi,5.41040838718,0.71481954465,"10"
"293","6101",西安市,Xian,4084759,5842704,3190073,2625134,2066619,2697711,1958971,2504155,107648,193556,7274832,8467838,3761041,4340803,3513791,4127035,6673518,7732794,858618,2345884,68874,542026,252508,1218311,242421,585547,4294704,4723853,2938320,3697719,61,陕西省,Shaanxi,6.33278878818,0.99763346662,"20"
"296","6104",咸阳市,Xianyang,1618288,2063586,3267715,3032415,1251390,1402384,1215426,1353942,35964,48442,4886003,5096001,2527141,2616681,2358862,2479320,4824699,5318086,203100,447182,67975,226412,65117,144812,23776,75958,3987951,3983521,871962,1092727,61,陕西省,Shaanxi,6.21071529405,1.00955781618,"1"
"298","6106",延安市,Yanan,578023,1057289,1438764,1129720,542553,663934,527297,646054,15256,17880,2016787,2187009,1057229,1149068,959558,1037941,1866111,2284889,235920,557795,99503,387926,67610,132636,16227,37233,1557469,1581212,430851,576080,61,陕西省,Shaanxi,12.7910024418,3.71060780711,"1"
"76","3102",上海市辖县,Shanghai (Counties),1030285,337350,1028914,366372,751812,305809,727146,293168,24666,12641,2059199,703722,1015988,359321,1043211,344401,1749321,692033,445400,194554,142138,30639,51621,12915,251641,151000,1557570,478027,480134,223361,31,上海市,Shanghai,4.11916238738,0.22130591353,"1"
"76","3102",上海市辖县,Shanghai (Counties),1030285,337350,1028914,366372,751812,305809,727146,293168,24666,12641,2059199,703722,1015988,359321,1043211,344401,1749321,692033,445400,194554,142138,30639,51621,12915,251641,151000,1557570,478027,480134,223361,31,上海市,Shanghai,4.11916238738,0.22130591353,"1"
"75","3101",上海市辖区,Shanghai (Districts),13459634,20217748,888901,2097726,4890776,8587674,4571922,7960089,318854,627585,14348535,22315474,7414274,11495595,6934261,10819879,10294787,13493127,4939189,12490762,0,1638648,1173531,2026114,2883281,8826000,4447429,8266066,9780290,13976511,31,上海市,Shanghai,4.55690026848,0.37014082544,"2"
"75","3101",上海市辖区,Shanghai (Districts),13459634,20217748,888901,2097726,4890776,8587674,4571922,7960089,318854,627585,14348535,22315474,7414274,11495595,6934261,10819879,10294787,13493127,4939189,12490762,0,1638648,1173531,2026114,2883281,8826000,4447429,8266066,9780290,13976511,31,上海市,Shanghai,4.55690026848,0.37014082544,"3"
"256","5119",巴中市,Bazhong,406200,934708,2883046,2348440,891673,967516,887115,959993,4558,7523,3289246,3283148,1698059,1669951,1591187,1613197,3356223,3939052,143150,231349,72390,188529,19093,34971,4960,7849,2885447,2625216,387964,633042,51,四川省,Sichuan,6.12082669046,1.17582261328,"1"
"240","5101",成都市,Chengdu,5967819,9237015,5140715,4810610,3457608,4829919,3317526,4547109,140082,282810,11108534,14047625,5706928,7138705,5401606,6908920,9502861,11426983,2131533,4697445,302493,824357,1077679,3271789,179710,601299,7358906,7793272,3693950,6209836,51,四川省,Sichuan,6.65832272611,1.13558119214,"9"
"244","5106",德阳市,Deyang,1202464,1493992,2585592,2121766,1212194,1317487,1192515,1296585,19679,20902,3788056,3615758,1954006,1827143,1834050,1788615,3641507,3869617,287336,465304,110821,239778,97275,186125,17695,39401,3070206,2614401,699702,990054,51,四川省,Sichuan,4.6354062561,0.56433202275,"1"
"240","5101",成都市,Chengdu,5967819,9237015,5140715,4810610,3457608,4829919,3317526,4547109,140082,282810,11108534,14047625,5706928,7138705,5401606,6908920,9502861,11426983,2131533,4697445,302493,824357,1077679,3271789,179710,601299,7358906,7793272,3693950,6209836,51,四川省,Sichuan,6.65832272611,1.13558119214,"1"
"253","5116",广安市,Guangan,686069,931959,3438031,2273517,1182549,1139077,1172755,1128089,9794,10988,4124100,3205476,2135327,1603068,1988773,1602408,4343067,4667164,147725,235918,69402,176962,26183,42368,13919,16588,3620902,2504810,469274,663446,51,四川省,Sichuan,4.61954997398,0.59596208708,"1"
"243","5105",泸州市,Luzhou,1086988,1487444,3015177,2730983,1273000,1284929,1256473,1268324,16527,16605,4102165,4218427,2117139,2138060,1985026,2080367,4416044,5043836,292391,425678,98888,221052,50374,160853,22805,43773,3400736,3319409,682870,812785,51,四川省,Sichuan,7.96138430892,1.12533300893,"1"
"251","5114",眉山市,Meishan,602180,975556,2602991,1974989,937470,1019836,919545,1010659,17925,9177,3205171,2950545,1637593,1471587,1567578,1478958,3287351,3489534,290440,314397,192673,218030,43199,79113,6936,17254,2820120,2215186,378267,719266,51,四川省,Sichuan,6.35476808784,0.67488900319,"2"
"250","5113",南充市,Nanchong,1402881,2254665,5280525,4023949,1915350,2070122,1897413,2046140,17937,23982,6683406,6278614,3468827,3187415,3214579,3091199,6941122,7525830,225530,548667,79263,352449,41727,164110,15712,32108,5692973,4699908,969652,1541179,51,四川省,Sichuan,6.36881968497,1.19039713709,"2"
"4","1202",天津市辖县,Tianjin (Counties),334409,715638,2015141,1132272,664462,563988,653922,553387,10540,10601,2349550,1847910,1191306,958845,1158244,889065,2238576,1763419,171677,231770,87305,89700,4362,7159,76406,134911,2005696,1516257,326614,324922,12,天津市,Tianjin,6.53892307574,0.62972283797,"1"
"3","1201",天津市辖区,Tianjin (Districts),6755403,9562255,743778,1528528,2414915,3399616,2322819,3108605,92096,291011,7499181,11090783,3825069,5948246,3674112,5142537,5885213,8156160,2009946,4720455,7788,1005582,51523,858283,658627,2856590,2355179,4893449,5096898,6147292,12,天津市,Tianjin,5.11225676696,0.58395162328,"2"
"3","1201",天津市辖区,Tianjin (Districts),6755403,9562255,743778,1528528,2414915,3399616,2322819,3108605,92096,291011,7499181,11090783,3825069,5948246,3674112,5142537,5885213,8156160,2009946,4720455,7788,1005582,51523,858283,658627,2856590,2355179,4893449,5096898,6147292,12,天津市,Tianjin,5.11225676696,0.58395162328,"1"
"3","1201",天津市辖区,Tianjin (Districts),6755403,9562255,743778,1528528,2414915,3399616,2322819,3108605,92096,291011,7499181,11090783,3825069,5948246,3674112,5142537,5885213,8156160,2009946,4720455,7788,1005582,51523,858283,658627,2856590,2355179,4893449,5096898,6147292,12,天津市,Tianjin,5.11225676696,0.58395162328,"4"
"3","1201",天津市辖区,Tianjin (Districts),6755403,9562255,743778,1528528,2414915,3399616,2322819,3108605,92096,291011,7499181,11090783,3825069,5948246,3674112,5142537,5885213,8156160,2009946,4720455,7788,1005582,51523,858283,658627,2856590,2355179,4893449,5096898,6147292,12,天津市,Tianjin,5.11225676696,0.58395162328,"1"
"270","5301",昆明市,Kunming,3176380,4337798,2604914,2094411,1783793,2250327,1672351,2099403,111442,150924,5781294,6432209,3039862,3306182,2741432,3126027,4229842,5413900,1771328,2046631,74086,379487,554526,1220317,578757,446827,3747796,3942950,1944288,2426216,53,云南省,Yunnan,10.0468272721,1.88306925864,"6"
"272","5304",玉溪市,Yuxi,577681,968805,1495324,1334713,592984,667397,579282,645607,13702,21790,2073005,2303518,1059623,1181282,1013382,1122236,1954770,2166932,181243,370943,50801,162511,65605,144081,45098,64351,1721186,1895676,332120,393422,53,云南省,Yunnan,9.72364855915,1.33183432783,"1"
"90","3301",杭州市,Hangzhou,4033397,6372650,2845325,2327723,2217984,3235877,2082829,2970849,135155,265028,6878722,8700373,3545062,4457154,3333660,4243219,5804502,6876483,1484481,3415109,242920,569398,458408,1102968,502715,1742743,4483091,4985694,2322395,3685162,33,浙江省,Zhejiang,8.0586733577,1.56902158952,"4"
"2","1102",北京市辖县,Beijing (Counties),645803,411835,1413796,373271,634076,296865,613217,285663,20859,11202,2059599,785106,1053615,398530,1005984,386576,1761589,708391,371831,209341,111952,84224,58425,16374,201454,108743,1498746,494144,538047,287461,11,北京市,Beijing,7.80577196826,0.87994396148,
"6","1302",唐山市,Tangshan,2265605,3850975,4774949,3726314,2117050,2428752,2078606,2375634,38444,53118,7040554,7577289,3582630,3871292,3457924,3705997,6680364,7335290,515989,956409,161018,529111,105862,237972,90215,189326,5129055,5436771,1892838,2103516,13,河北省,Hebei,7.40708879167,1.37008695228,
"7","1303",秦皇岛市,Qinhuangdao,900132,1419487,1853830,1568118,855025,986756,834385,957621,20640,29135,2753962,2987605,1403179,1516194,1350783,1471411,2539977,2879710,286787,495302,35069,208005,68259,138966,101670,148331,2001494,2012069,744787,964251,13,河北省,Hebei,4.95602282375,0.81942459898,
"15","1311",衡水市,Hengshui,827498,1657687,3329415,2683086,1140571,1277786,1123044,1258305,17527,19481,4156913,4340773,2103988,2191113,2052925,2149660,4074336,4358082,155513,293860,66918,209392,36178,59705,34159,24763,3604080,3692442,547570,635555,13,河北省,Hebei,5.65284411246,0.90242422944,
"17","1402",大同市,Datong,1305923,1822112,1695585,1495942,899602,1104779,888361,1086073,11241,18706,3001508,3318054,1550741,1689841,1450767,1628213,2407331,3200040,710106,833558,107140,461292,122752,244176,163763,128090,1799739,1776950,1148795,1515000,14,山西省,Shanxi,8.73888467016,1.4768377263,
"18","1403",阳泉市,Yangquan,580478,821209,692648,547293,374499,436649,366289,428541,8210,8108,1273126,1368502,668004,710304,605122,658198,1122363,1312234,199244,296268,36127,118029,43551,127136,34144,51103,736132,696078,527839,663605,14,山西省,Shanxi,3.62049319436,0.46972777935,
"19","1404",长治市,Changzhi,896487,1395030,2242504,1939535,831005,948144,817897,923466,13108,24678,3138991,3334565,1621512,1710681,1517479,1623884,2969007,3336682,256629,432937,85926,246778,52044,131245,33880,54914,2454746,2340353,663264,960018,14,山西省,Shanxi,6.83376556348,1.40607531374,
"20","1405",晋城市,Jincheng,738794,1163315,1422190,1115831,607621,686084,591283,662706,16338,23378,2160984,2279146,1112138,1153981,1048846,1125165,1961016,2169173,249653,420226,62552,195768,60609,147900,67925,76558,1764970,1711080,381067,553469,14,山西省,Shanxi,4.9208662727,0.94219585337,
"21","1406",朔州市,Shuozhou,516353,793560,935522,921297,389192,498797,385121,485730,4071,13067,1451875,1714857,753046,895412,698829,819445,1281648,1594336,221088,455191,76556,296826,46752,107588,30065,50777,1103246,1234063,315693,456232,14,山西省,Shanxi,6.0126784896,1.11787202769,
"22","1407",晋中市,Jinzhong,975263,1433792,2041273,1815633,884138,1031598,868910,1002346,15228,29252,3016536,3249425,1571127,1694946,1445409,1554479,2820473,3172151,333812,670046,145009,408045,65472,164438,46794,97563,2278627,2318028,708109,900782,14,山西省,Shanxi,9.17135694776,1.66390991903,
"23","1408",运城市,Yuncheng,1050196,1928843,3762165,3205936,1182041,1364746,1162691,1336278,19350,28468,4812361,5134779,2464300,2615684,2348061,2519095,4710784,5037695,220458,467936,97963,336996,40748,99672,31719,31268,4149518,4308447,652547,807802,14,山西省,Shanxi,6.30604097861,1.39503970468,
"24","1409",忻州市,Xinzhou,792953,1161317,2145391,1906186,829251,941149,817916,921407,11335,19742,2938344,3067503,1534626,1581660,1403718,1485843,2724100,3069742,284405,560404,149149,414322,55072,93651,32437,52431,2359999,2368647,538050,659500,14,山西省,Shanxi,10.1719660104,2.60735274698,
"25","1410",临汾市,Linfen,1062335,1760260,2888510,2556350,982060,1182779,966003,1148571,16057,34208,3950845,4316610,2025713,2200819,1925132,2115791,3796336,4366211,257769,527948,108219,347019,49870,119325,49261,61604,3159484,3265975,771232,1018585,14,山西省,Shanxi,8.47036608869,2.02227313813,
"26","1423",吕梁地区,Lvliangdiqu,757487,1413114,2624793,2313954,869259,1064253,860454,1038798,8805,25455,3382280,3727068,1758138,1933713,1624142,1793355,3310051,3820128,153276,550184,91906,370759,33956,135870,20549,43555,2865872,2918661,491623,767461,14,山西省,Shanxi,8.92504874448,2.14496680898,
"28","1502",包头市,Baotou,1549075,2106757,705364,543607,750877,973498,733402,939459,17475,34039,2254439,2650364,1169609,1368885,1084830,1281479,1719467,2191816,711323,1139359,36552,342746,247348,589756,84067,206857,972023,1266616,1251369,1368376,15,内蒙古,Neimenggu,11.3322677079,2.9939915555,
"29","1503",乌海市,Wuhai,397716,502704,29837,30198,140390,195764,136468,187773,3922,7991,427553,532902,223947,282386,203606,250516,371005,453968,98460,227133,0,58831,39892,88769,26471,79533,105411,150083,315729,377694,15,内蒙古,Neimenggu,1.88166385801,0.16079911534,
"30","1504",赤峰市,Chifeng,1192381,1786902,3243356,2554343,1228994,1397216,1213005,1373247,15989,23969,4435737,4341245,2280139,2234825,2155598,2106420,4188361,4583636,379274,741212,135195,436604,62439,241886,26862,62722,3536526,3277522,880975,1046757,15,内蒙古,Neimenggu,19.617716944,9.43350246715,
"31","1505",通辽市,Tongliao,861319,1267782,2167100,1871371,799930,962862,793449,948038,6481,14824,3028419,3139153,1545728,1597918,1482691,1541235,2870035,3191254,211454,421073,76432,288627,23428,86245,20416,46201,2331181,2232858,686794,898220,15,内蒙古,Neimenggu,16.6216237015,6.58797842495,
"32","1521",呼伦贝尔盟,Hulunbeier,1750292,1722795,936936,826457,797651,908154,789970,896713,7681,11441,2687228,2549252,1384047,1311859,1303181,1237393,2379392,2718249,433093,515442,168453,221763,109783,133883,154857,159796,1078366,880680,1547418,1650345,15,内蒙古,Neimenggu,40.5983761354,31.4927923506,
"33","1522",兴安盟,Xingan,537921,678362,1050866,934884,429507,526355,425423,519990,4084,6365,1588787,1613246,820495,828637,768292,784609,1539971,1672928,128723,226402,71390,126543,35849,64266,21484,35593,1108765,1042658,462442,562514,15,内蒙古,Neimenggu,18.3818953708,6.41081345183,
"34","1525",锡林郭勒盟,Xilinguole,449721,628458,525447,399564,299217,365145,294302,355655,4915,9490,975168,1028022,505875,536795,469293,491227,808140,983378,232308,341157,83719,102925,121730,176469,26859,61763,601218,577690,358990,443663,15,内蒙古,Neimenggu,29.8955979026,22.6570921915,
"35","1526",乌兰察布盟,Wulanchabu,648166,905935,1636248,1237655,717137,802538,709582,794267,7555,8271,2284414,2143590,1184244,1094705,1100170,1048885,2237308,2866361,270284,424093,187132,272133,69309,120382,13843,31578,1741999,1519878,521954,614138,15,内蒙古,Neimenggu,15.7625181034,5.91643145803,
"36","1527",伊克昭盟,Yikezhao,595706,1349254,774060,591399,438921,665772,424062,604414,14859,61358,1369766,1940653,728605,1106242,641161,834411,1174989,1510861,328507,1079102,158796,320851,110886,348259,58825,409992,976556,1402216,377468,527105,15,内蒙古,Neimenggu,17.6175625722,9.08337816605,
"37","1528",巴彦淖尔盟,Bayannaoer,620801,808343,1061861,861572,493393,580972,484032,555161,9361,25811,1682662,1669915,869853,887011,812809,782904,1521081,1827679,301941,560608,169961,244261,92473,194376,39507,121971,1164470,1146398,492061,512193,15,内蒙古,Neimenggu,13.8497292128,6.94009357585,
"38","1529",阿拉善盟,Alashan,133560,172200,62719,59134,60436,84417,58398,77909,2038,6508,196279,231334,104337,126204,91942,105130,160958,171187,48681,101791,20711,24881,7680,18615,20290,58295,86987,115148,106069,114830,15,内蒙古,Neimenggu,32.6885379094,25.6117136349,
"41","2103",鞍山市,Anshan,2204629,2449061,1379410,1196823,1099641,1244885,1090358,1232076,9283,12809,3584039,3645884,1830683,1850084,1753356,1795800,3124710,3533679,561444,629633,117350,352622,83293,182455,79161,94556,1763025,1809853,1791812,1823229,21,辽宁省,Liaoning,7.97782697444,0.97963638988,
"42","2104",抚顺市,Fushun,1616393,1531774,643897,606316,719712,800812,714056,789563,5656,11249,2260290,2138090,1147861,1080753,1112429,1057337,2055888,2220545,300846,307318,22731,166146,56360,109731,28076,31441,756203,685855,1488224,1447139,21,辽宁省,Liaoning,6.90623571793,1.22061013718,
"43","2105",本溪市,Benxi,1070461,1271246,496947,438292,486797,590410,481769,584175,5028,6235,1567408,1709538,797791,873808,769617,835730,1381127,1560115,221947,340464,23405,167446,30535,126586,18980,46432,547405,564558,1013294,1142045,21,辽宁省,Liaoning,7.50842479286,0.90732580798,
"44","2106",丹东市,Dandong,1311565,1475118,1078959,969579,730823,831981,723143,815728,7680,16253,2390524,2444697,1213218,1239795,1177306,1204902,2193665,2429211,303129,460589,92551,257157,53913,147441,30184,55991,1394663,1390586,984755,1049317,21,辽宁省,Liaoning,8.64813918378,1.57697623357,
"45","2107",锦州市,Jinzhou,1359268,1496433,1717467,1630030,964935,1055468,953019,1038641,11916,16827,3076735,3126463,1563925,1566255,1512810,1560208,2823218,3086773,355658,439534,93617,215843,81182,184685,35014,39006,1969976,1845308,1091431,1270572,21,辽宁省,Liaoning,7.64160744462,1.04885437129,
"46","2108",营口市,Yingkou,1111229,1429218,1185311,999316,679003,832586,671595,822535,7408,10051,2296540,2428534,1180105,1243569,1116435,1184965,1943145,2365657,412031,512192,153026,288773,65933,129902,55040,93517,1390011,1244371,888233,1172730,21,辽宁省,Liaoning,4.62888634182,0.55074471966,
"47","2109",阜新市,Fuxin,840048,954714,1049726,864625,578004,642311,573388,635206,4616,7105,1889774,1819339,954303,913619,935471,905720,1766402,1920010,195298,265270,20962,153007,40306,92612,12146,19651,1050068,988391,830617,825104,21,辽宁省,Liaoning,5.9839583842,1.13585277764,
"48","2110",辽阳市,Liaoyang,924563,1039033,876644,819735,577261,647846,572246,639500,5015,8346,1801207,1858768,921568,945546,879639,913222,1576295,1828891,282357,378256,44578,167626,71817,157659,40659,52971,1029638,1060103,755338,787945,21,辽宁省,Liaoning,4.21177861181,0.50134675756,
"49","2111",盘锦市,Panjin,734623,918461,527130,474032,401690,485825,395918,479397,5772,6428,1261753,1392493,647724,703258,614029,689235,1063037,1305678,238968,289916,30504,131849,82134,111263,44254,46804,642245,273266,608504,1113899,21,辽宁省,Liaoning,6.58949535815,0.35022444359,
"50","2112",铁岭市,Tieling,1092582,1145784,1730638,1571948,869201,929259,866192,924161,3009,5098,2823220,2717732,1441343,1378537,1381877,1339195,2719489,3037127,238573,280697,80813,198470,70824,58060,21252,24167,1931722,1758617,868601,947221,21,辽宁省,Liaoning,7.59813767386,1.42525835214,
"51","2113",朝阳市,Chaoyang,1059254,1160438,2135574,1884203,943554,1026380,939238,1013043,4316,13337,3194828,3044641,1634950,1547066,1559878,1497575,3110659,3399665,231497,416141,37694,281704,81217,100386,13172,34051,2363007,2185517,816735,830203,21,辽宁省,Liaoning,9.92423098506,2.12355116537,
"52","2114",葫芦岛市,Huludao,840671,1089843,1740014,1533698,786853,864073,782379,855986,4474,8087,2580685,2623541,1325484,1334538,1255201,1289003,2454478,2810255,229183,383801,63730,247200,32342,105101,23685,31500,1848016,1774442,716265,832736,21,辽宁省,Liaoning,7.0915073672,1.09915372177,
"53","2201",长春市,Changchun,3552740,4258161,3582699,3416278,2043731,2422128,1996903,2328933,46828,93195,7135439,7674439,3649974,3877174,3485465,3797265,6359756,7548923,1022148,1761784,178365,791561,253361,755179,106784,215044,4148345,4195812,2930777,3454580,22,吉林省,Jilin,10.3442456299,2.30851017363,
"54","2202",吉林市,Jilin,2481880,2486066,2003614,1927091,1343531,1503854,1325242,1478120,18289,25734,4485494,4413157,2287359,2233750,2198135,2179407,4121656,4346767,474216,725902,133313,471297,99140,199807,39972,54798,2293598,2200987,2159063,2197035,22,吉林省,Jilin,10.3411649415,3.07305114671,
"56","2204",辽源市,Liaoyuan,637001,596028,630032,580211,378219,401528,376274,398828,1945,2700,1267033,1176239,651909,598230,615124,578009,1179718,1231270,122351,135535,36192,101740,15234,28147,6166,5648,679726,632522,578726,540119,22,吉林省,Jilin,3.84324728862,0.5685114607,
"57","2205",通化市,Tonghua,1173654,1238104,1134310,1086335,690696,777270,685540,771490,5156,5780,2307964,2324439,1186217,1183624,1121747,1140815,2148665,2257789,242552,250905,122233,187899,46424,36166,19171,26840,1219763,1178445,1067213,1138534,22,吉林省,Jilin,9.27706453773,1.69218401467,
"58","2206",白山市,Baishan,979261,969899,333101,326228,420792,516257,416997,513009,3795,3248,1312362,1296127,677324,660809,635038,635318,1202157,1268316,144101,220647,63164,164132,24631,37303,17291,19212,429118,360360,876272,930735,22,吉林省,Jilin,9.28873454154,1.89940014135,
"59","2207",松原市,Songyuan,875507,1111883,1890529,1768203,770321,882919,764107,878395,6214,4524,2766036,2880086,1411605,1455739,1354431,1424347,2561974,2888567,231108,384020,76649,258776,47596,110582,11322,14662,2057635,2123673,696540,743193,22,吉林省,Jilin,10.0122947907,2.41325799019,
"60","2208",白城市,Baicheng,946241,983502,1079650,1048854,621452,748201,617199,744888,4253,3313,2025891,2032356,1037881,1032194,988010,1000162,1897472,2037013,185733,244873,99806,191096,24616,34997,14048,18780,1195355,1186091,820773,840367,22,吉林省,Jilin,10.3176120961,2.95110468439,
"61","2224",延边朝鲜族自治州,Yanbianchaoxianzu,1485818,1597452,723828,673364,721889,862452,711717,848088,10172,14364,2209646,2270816,1134339,1150219,1075307,1120597,1996978,2188851,362648,459808,181698,229856,99044,145354,76772,84598,864708,825850,1297924,1439425,22,吉林省,Jilin,16.5212607444,4.80828058853,
"62","2301",哈尔滨市,Haerbin,5370174,6501848,4043185,4134123,2824453,3512739,2778730,3408940,45723,103799,9413359,10635971,4797249,5402739,4616110,5233232,8518236,9964761,1237790,2070990,217955,937126,389869,939105,100875,194759,4909426,5200037,4410863,5394755,23,黑龙江省,Heilongjiang,17.0365156119,6.13438117431,
"63","2302",齐齐哈尔市,Qiqihaer,2238149,2366355,3181472,3000648,1631682,1823664,1620203,1810534,11479,13130,5419621,5367003,2767685,2710067,2651936,2656936,5297524,5692710,303073,461173,72865,314478,84764,98787,30466,47908,3360916,3255623,2034319,2094769,23,黑龙江省,Heilongjiang,17.4509789922,5.05815594381,
"64","2303",鸡西市,Jixi,1237968,1223140,708089,639025,623128,719372,616510,713808,6618,5564,1946057,1862165,1001532,950892,944525,911273,1763432,1892636,240805,299219,48699,166626,88871,97999,33141,34594,814755,706242,1120267,1152519,23,黑龙江省,Heilongjiang,12.1018987849,2.58991405285,
"65","2304",鹤岗市,Hegang,844927,810873,254152,247792,361130,401559,359015,397954,2115,3605,1099079,1058665,561342,536776,537737,521889,985414,1073585,143089,156466,15674,77755,49399,62738,22377,15973,243823,226090,844938,830000,23,黑龙江省,Heilongjiang,9.33445646739,1.75588709696,
"66","2305",双鸭山市,Shuangyashan,807926,890815,640423,571811,463331,552082,460519,550098,2812,1984,1448349,1462626,743273,741730,705076,720896,1297531,1476353,207575,226128,42279,118255,95480,87678,29036,20195,618139,553056,818910,906034,23,黑龙江省,Heilongjiang,12.5908040533,2.59785227204,
"67","2306",大庆市,Daqing,1386842,1846892,1191209,1057640,815264,989812,800430,967070,14834,22742,2578051,2904532,1316065,1464252,1261986,1440280,2254238,2803822,416588,614996,33619,207917,253460,346104,56439,60975,1379929,1447642,1179267,1442397,23,黑龙江省,Heilongjiang,11.3000026616,2.47249430482,
"68","2307",伊春市,Yichun,1126748,964391,122873,183735,421348,465666,419243,462944,2105,2722,1249621,1148126,636128,574363,613493,573763,1180959,1288574,123016,96284,14631,51116,53235,39222,8888,5946,208028,157820,1028372,988379,23,黑龙江省,Heilongjiang,15.0746131343,3.94473203642,
"69","2308",佳木斯市,Jiamusi,1085998,1355497,1272312,1196600,721776,892460,714641,885958,7135,6502,2358310,2552097,1205394,1306592,1152916,1245505,2201807,2494497,231128,364878,33949,222043,83449,122448,18107,20387,1216091,1247433,1118931,1298372,23,黑龙江省,Heilongjiang,20.1893972678,3.87382545764,
"70","2309",七台河市,Qitaihe,558308,623337,249132,297134,253737,344312,251494,342089,2243,2223,807440,920471,418995,471513,388445,448958,642289,861838,199639,242405,13147,105629,82832,115893,28453,20883,382590,396766,413845,519972,23,黑龙江省,Heilongjiang,5.36497934703,0.72219461846,
"71","2310",牡丹江市,Mudanjiang,1485829,1610348,1198666,1188375,836417,968648,827660,955603,8757,13045,2684495,2798723,1368299,1413360,1316196,1385363,2615000,2716098,135437,426386,23690,197039,48619,184889,20786,44458,1255332,1299595,1415961,1493951,23,黑龙江省,Heilongjiang,13.5162448578,4.37427524864,
"72","2311",黑河市,Heihe,650825,880066,1020986,793833,536360,631313,532960,622642,3400,8671,1671811,1673899,858924,847863,812887,826036,1542003,1716359,201020,243147,76267,139977,85932,82819,17400,20351,792409,755363,868818,911121,23,黑龙江省,Heilongjiang,19.4916636943,8.27244739425,
"73","2312",绥化市,Suihua,1428371,1799806,3627170,3618347,1416965,1694939,1410314,1688388,6651,6551,5055541,5418153,2585369,2741591,2470172,2676562,5018302,5744698,235508,272322,151831,232200,35211,32918,5466,7204,3727521,4000272,1299670,1402593,23,黑龙江省,Heilongjiang,15.6539474939,4.12119529416,
"74","2327",大兴安岭地区,Daxinganlingdiqu,449974,450347,55868,61213,165331,196369,164031,194060,1300,2309,505842,511560,260492,264368,245350,247192,429007,511972,93743,83434,22576,30566,55960,40104,15207,12764,95173,76739,406234,433321,23,黑龙江省,Heilongjiang,21.9946488056,9.15375514897,
"79","3203",徐州市,Xuzhou,2981759,4561500,5932206,4015725,2504337,2646493,2459453,2610420,44884,36073,8913965,8577225,4568544,4313811,4345421,4263414,8556065,9759913,628119,868711,165451,443310,123551,302111,89495,123290,6734884,6102144,2113261,2367769,32,江苏省,Jiangsu,8.08969327331,1.10293174321,
"84","3208",淮阴市,Huaiyin,1448492,2438667,3589739,2362995,1330670,1423877,1315573,1390682,15097,33195,5038231,4801662,2576525,2387443,2461706,2414219,4903907,5424286,314474,629456,130865,346835,80633,219535,23124,63086,3887317,3426565,1104204,1317650,32,江苏省,Jiangsu,6.36863136552,0.96807848747,
"85","3209",盐城市,Yancheng,2829848,3772779,5116696,3489421,2427619,2433515,2395872,2400777,31747,32738,7946544,7262200,4059913,3650872,3886631,3611328,7644780,8203733,589691,733658,281835,433875,128034,226342,43734,73441,6027881,5078417,1869095,2075623,32,江苏省,Jiangsu,8.88635546687,1.4471999664,
"91","3302",宁波市,Ningbo,3323736,5195162,2639626,2410527,2113581,3006825,2010181,2855142,103400,151683,5963362,7605689,3031634,3883564,2931728,3722125,4943568,5747621,1355749,3146005,258861,556234,326437,606323,612047,1983448,4504841,5596732,1414785,1979422,33,浙江省,Zhejiang,11.8092861724,0.80095586551,
"92","3303",温州市,Wenzhou,3891314,6022031,3666326,3100071,2150059,3163105,1998828,2910274,151231,252831,7557640,9122102,3986631,4797359,3571009,4324743,6317574,7852774,2030928,4149891,426736,911515,333536,513833,1021193,2724543,6177826,7506722,1208292,1482987,33,浙江省,Zhejiang,10.3432659631,1.03983255917,
"93","3304",嘉兴市,Jiaxing,1360825,2400663,2222171,2100994,1048904,1541355,1015166,1449492,33738,91863,3582996,4501657,1796646,2269227,1786350,2232430,3236234,3432862,461061,1568575,80035,265455,62183,179622,257262,1123498,2771874,3284011,788645,1191214,33,浙江省,Zhejiang,3.30657751237,0.37170219272,
"94","3305",湖州市,Huzhou,1016669,1530418,1608926,1363124,768393,943371,751428,903467,16965,39904,2625595,2893542,1333340,1470472,1292255,1423070,2447359,2598712,310095,750610,50357,208485,41343,88094,144964,454031,1980507,2112396,619121,767430,33,浙江省,Zhejiang,4.22701012112,0.54984390338,
"95","3306",绍兴市,Shaoxing,2095350,2877624,2208891,2034615,1455049,1830205,1410009,1739568,45040,90637,4304241,4912239,2155557,2469399,2148684,2442840,4017322,4391870,638145,1589138,230312,489775,104042,192841,226685,906522,3489363,3527955,787402,1368812,33,浙江省,Zhejiang,4.94670273182,0.74132580843,
"96","3307",金华市,Jinhua,2073217,3161801,2498664,2199771,1563490,2085268,1490627,1942210,72863,143058,4571881,5361572,2345303,2777642,2226578,2583930,4090295,4645488,888115,1921859,264456,442556,182740,255081,387828,1224222,3815385,4343971,729462,978839,33,浙江省,Zhejiang,5.70383732764,1.01298148504,
"97","3308",衢州市,Quzhou,629671,936833,1499185,1185828,713473,785940,704533,767535,8940,18405,2128856,2122661,1105195,1082602,1023661,1040059,2288950,2491780,160070,407191,81018,220076,43255,107284,19216,79831,1739021,1669169,376436,437392,33,浙江省,Zhejiang,5.20047708151,0.81698431586,
"98","3309",舟山市,Zhoushan,561170,713057,440360,408204,360749,454822,351086,430011,9663,24811,1001530,1121261,506171,588414,495359,532847,891611,969734,197370,424117,20282,142113,31762,68079,45638,213925,713931,768193,278704,347975,33,浙江省,Zhejiang,10.8143788734,0.11385432523,
"99","3310",台州市,Taizhou,2655840,3315319,2497875,2653519,1684241,2218808,1617400,2115870,66841,102938,5153715,5968838,2648968,3081620,2504747,2887218,4866567,5825930,832759,1885797,184136,460294,100474,204172,445811,1221331,4304340,4998678,820797,914019,33,浙江省,Zhejiang,10.8642549279,0.86104307061,
"100","3311",丽水市,Lishui,715385,1024651,1446728,1092306,713746,794539,704829,769603,8917,24936,2162113,2116957,1127005,1088188,1035108,1028769,2209974,2498266,239889,642571,129846,360930,53252,131758,25492,149883,1809744,1728425,323693,368441,33,浙江省,Zhejiang,7.49079884835,1.57874123614,
"102","3402",芜湖市,Wuhu,904872,1475022,1210549,788101,643850,826566,631945,781367,11905,45199,2115421,2263123,1096089,1165745,1019332,1097378,2004707,2307630,247543,510397,30200,182580,67819,244064,20368,83753,1412464,1226489,691724,1026128,34,安徽省,Anhui,3.58791644814,0.31613623961,
"103","3403",蚌埠市,Bengbu,1010127,1373554,2278202,1790913,868538,989597,857725,972791,10813,16806,3288329,3164467,1705466,1612771,1582863,1551696,3185465,3656418,244218,331407,49369,171729,57834,134262,15710,25416,2499989,2128053,774514,969008,34,安徽省,Anhui,4.48385831277,0.57020825336,
"104","3404",淮南市,Huainan,1155063,1442117,885586,891779,564479,783279,554490,760678,9989,22601,2040649,2333896,1064641,1212024,976008,1121872,1902227,2462734,241775,368755,27068,182900,77966,161911,9592,23944,1151081,1141067,873488,1156123,34,安徽省,Anhui,2.46714868807,0.20568003126,
"105","3405",马鞍山市,Maanshan,602528,939447,594388,426855,366610,466161,360503,452888,6107,13273,1196916,1366302,617633,704432,579283,661870,1108840,1294752,156717,280283,16187,123446,54371,122830,12778,34007,693462,684813,498812,673732,34,安徽省,Anhui,1.91458318136,0.16401390919,
"106","3406",淮北市,Huaibei,776583,1119551,1101581,994725,515308,635263,503697,625431,11611,9832,1878164,2114276,968448,1070553,909716,1043723,1822528,2203038,108960,211254,19870,105276,37725,88757,6765,17221,1230980,1140618,634312,948961,34,安徽省,Anhui,2.91700473772,0.26184787147,
"107","3407",铜陵市,Tongling,393246,526261,291470,197697,215908,268232,210717,260252,5191,7980,684716,723958,354550,369663,330166,354295,651198,741823,84004,117043,6583,31827,38394,73369,4595,11847,338347,292807,343535,428597,34,安徽省,Anhui,1.51964833649,0.0978038892,
"108","3408",安庆市,Anqing,1157013,1953494,4022987,3357885,1503930,1629196,1484647,1593746,19283,35450,5180000,5311379,2594671,2685349,2585329,2626030,5730309,6187361,283598,519918,113190,316937,56194,170652,13930,32329,4345663,4197121,817472,1052979,34,安徽省,Anhui,6.69765169963,1.45003919383,
"109","3410",黄山市,Huangshan,389462,555163,980915,803817,435140,468889,429808,454386,5332,14503,1370377,1358980,698531,690085,671846,668895,1396469,1477219,106659,198506,35590,100084,24252,71359,8254,27063,1083207,995161,281001,355238,34,安徽省,Anhui,5.70802617237,0.90028921252,
"110","3411",滁州市,Chuzhou,997241,1634370,3004247,2303498,1114479,1254713,1106321,1235697,8158,19016,4001488,3937868,2053464,1999579,1948024,1938289,4044077,4533540,213214,400151,98528,243716,45612,111201,20893,45234,3295149,2991411,682249,903035,34,安徽省,Anhui,8.11764046387,1.30194721267,
"111","3412",阜阳市,Fuyang,1757961,2393124,6246002,5206789,2157051,2524677,2146768,2507792,10283,16885,8003963,7599913,4124437,3762319,3879526,3837594,8435219,10142914,196003,437712,76067,271617,36911,130500,11396,35595,7231043,6437807,754703,956760,34,安徽省,Anhui,6.45334847534,0.97151851367,
"112","3413",宿州市,Suzhou,848316,1670862,4668107,3682062,1467381,1632184,1458256,1608582,9125,23602,5516423,5352924,2818699,2698929,2697724,2653995,5560070,6389236,227376,322229,63885,240887,38314,55943,13665,25399,4912571,4474138,581182,810550,34,安徽省,Anhui,7.60019342974,0.97547907651,
"113","3414",巢湖市,Chaohu,850923,1574316,3322526,2298786,1160098,1226305,1150864,1212100,9234,14205,4173449,3873102,2158799,1967100,2014650,1906002,4242686,4608039,197271,316540,73622,202597,35633,73319,12679,40624,3563147,3114191,576950,698181,34,安徽省,Anhui,4.82532111157,0.89578226582,
"114","3415",六安市,Liuan,1103300,1954534,4851353,3657167,1671462,1830437,1660462,1807765,11000,22672,5954653,5611701,3092791,2861086,2861862,2750615,6307267,7118445,186739,404993,89110,264590,23657,115276,7405,25127,5162007,4618680,779205,924457,34,安徽省,Anhui,8.25310067498,1.75038530252,
"115","3416",亳州市,Bozhou,956551,1358721,4122357,3491936,1334074,1503509,1330745,1495949,3329,7560,5078908,4850657,2648172,2459168,2430736,2391489,5100021,6102805,119847,211637,53578,171886,10672,24450,7040,15301,4649441,4298022,417037,437423,34,安徽省,Anhui,5.22279698928,0.8309509341,
"116","3417",池州市,Chizhou,323962,622834,1065507,779684,412853,438525,407852,425181,5001,13344,1389469,1402518,705077,706180,684392,696338,1465019,1596790,76115,153021,30640,97057,19578,39557,5654,16407,1170757,1120166,214440,273550,34,安徽省,Anhui,5.39052550141,0.7937061799,
"117","3418",宣城市,Xuancheng,575233,1096474,2084406,1436464,793276,851332,785010,834961,8266,16371,2659639,2532938,1390818,1298040,1268821,1234898,2597740,2778003,188487,369860,70216,249064,28562,58851,20289,61945,2239774,1986882,412389,530716,34,安徽省,Anhui,6.7111398924,1.16470407374,
"119","3502",厦门市,Xiamen,1454450,3119110,598620,412237,660503,1407923,547540,1239957,112963,167966,2053070,3531347,1061697,1832194,991373,1699153,1231804,1778591,893523,2151224,2182,162879,332713,964576,415194,1023769,1273098,2257166,766495,1253455,35,福建省,Fujian,3.59362120087,0.13057661356,
"120","3503",莆田市,Putian,795549,1411015,1932374,1367493,691747,803389,663845,761131,27902,42258,2727923,2778508,1316455,1379116,1411468,1399392,2790974,3237428,285407,523209,61829,163509,93292,169537,70918,190163,2363814,2376154,324477,348031,35,福建省,Fujian,6.22642141667,0.33775891317,
"121","3504",三明市,Sanming,993510,1279742,1580565,1223646,733190,803720,711373,778028,21817,25692,2574075,2503388,1353844,1308101,1220231,1195287,2486075,2738183,337820,549668,123930,253187,122823,177369,67042,119112,1940845,1821058,618938,625580,35,福建省,Fujian,9.18650898919,2.07954903004,
"122","3505",泉州市,Quanzhou,2835210,4749504,4447830,3379029,1891204,2523493,1671139,2267868,220065,255625,7283040,8128533,3724882,4207539,3558158,3920994,6145880,6913198,1645013,2914894,216490,509527,372060,713706,922228,1691661,6350069,6896867,892005,1088839,35,福建省,Fujian,9.1219789706,0.97227389808,
"123","3506",漳州市,Zhangzhou,1607608,2247564,2974067,2562419,1211876,1387914,1182936,1338117,28940,49797,4581675,4809983,2360095,2468870,2221580,2341113,4341396,4808524,365880,699766,115703,265914,90532,226681,93946,207171,3805813,3902998,744797,824791,35,福建省,Fujian,10.4230560636,1.11227368929,
"124","3507",南平市,Nanping,1225752,1342334,1590829,1303214,840362,914437,821622,893150,18740,21287,2816581,2645548,1477653,1358661,1338928,1286887,2768553,3142176,364196,602505,154355,384616,80691,111701,73454,106188,2075576,1907370,729415,689919,35,福建省,Fujian,9.97068815688,2.40155686921,
"125","3508",龙岩市,Longyan,965696,1152257,1718614,1407288,731448,880882,702002,845533,29446,35349,2684310,2559545,1387064,1320167,1297246,1239378,2674689,2958045,326161,635540,95530,331834,87812,181947,80416,121759,2201552,2048557,474145,480567,35,福建省,Fujian,8.08851215765,1.7101789452,
"126","3509",宁德市,Ningde,1069986,1352338,1921272,1469658,787712,925866,773821,905233,13891,20633,2991258,2821996,1596693,1476310,1394565,1345686,2987326,3332920,260279,622763,155702,478102,45599,80546,26576,64115,2510149,2289215,465820,488146,35,福建省,Fujian,16.2670259264,1.18449112241,
"130","3604",九江市,Jiujiang,1248560,2011155,3152688,2717623,1128402,1259240,1105542,1228705,22860,30535,4401248,4728778,2283008,2402409,2118240,2326369,4219976,4987247,382674,536989,181277,335652,61790,127868,48601,73469,3420675,3441600,936463,1214342,36,江西省,Jiangxi,9.4078640634,1.74916751717,
"132","3606",鹰潭市,Yingtan,357043,533682,670032,591474,282286,302705,277849,296472,4437,6233,1027075,1125156,538206,590971,488869,534185,1023873,1176925,88059,129133,32339,77624,23441,37919,7620,13590,759575,799710,259664,303308,36,江西省,Jiangxi,3.25569617565,0.32384308688,
"134","3608",吉安市,Jian,955122,1808990,3405802,3001349,1107502,1282773,1073741,1257623,33761,25150,4360924,4810339,2265302,2498021,2095622,2312318,4373296,4984078,338002,365743,198154,280985,54695,49059,27295,35699,3480292,3751409,844641,975810,36,江西省,Jiangxi,9.13546562335,2.30025844263,
"136","3610",抚州市,Fuzhou,914625,1456007,2657796,2456300,906996,1053140,887579,1041056,19417,12084,3572421,3912307,1870642,2037160,1701779,1875147,3530887,4112200,233190,360236,118679,293119,28044,43177,10116,23940,2776546,2932303,752707,907148,36,江西省,Jiangxi,8.31372353111,1.72303056055,
"137","3611",上饶市,Shangrao,1017529,2614106,4960149,3965641,1515604,1682638,1504968,1658249,10636,24389,5977678,6579747,3109685,3396219,2867993,3183528,6341281,7482546,212830,467483,127561,334752,42146,83861,16244,48870,5007027,5153679,927495,1290399,36,江西省,Jiangxi,11.2534414068,2.10611597455,
"140","3703",淄博市,Zibo,2210363,2859540,1974067,1671057,1353386,1554323,1310276,1524413,43110,29910,4184430,4530597,2112493,2272512,2071937,2258085,3831636,4231819,485903,802643,57300,427090,149222,288870,50687,86683,2794248,2948731,1374109,1561820,37,山东省,Shandong,5.74807462422,0.61265479568,
"141","3704",枣庄市,Zaozhuang,1389654,1764366,2155961,1964774,1003982,1112090,988496,1099307,15486,12783,3545615,3729140,1837189,1943932,1708426,1785208,3350099,3919007,280257,354024,154809,270491,27540,68014,13089,15519,2723107,2707791,804509,945865,37,山东省,Shandong,3.43202766133,0.44993126075,
"142","3705",东营市,Dongying,865462,1221644,927709,813694,573283,711466,551496,679068,21787,32398,1793171,2035338,914969,1030852,878202,1004486,1546000,1868136,299555,476692,27842,181750,137576,220896,40059,74046,1166797,1240623,618636,779744,37,山东省,Shandong,6.23083195412,0.6377022309,
"144","3707",潍坊市,Weifang,3448012,4266496,5047288,4819745,2485537,2746912,2437039,2693924,48498,52988,8495300,9086241,4286748,4600438,4208552,4485803,8091146,8775623,637333,1241471,322200,737418,97135,347866,79320,156187,6950780,7199296,1512126,1811924,37,山东省,Shandong,7.55301738454,1.58248529863,
"145","3708",济宁市,Jining,2679982,3472780,5060299,4609125,2172576,2410618,2134082,2374970,38494,35648,7740281,8081905,3952232,4118415,3788049,3963490,7621172,8459305,412935,776078,206760,452284,74646,277006,37324,46788,6228788,6379382,1489175,1582756,37,山东省,Shandong,8.43549572502,1.1045082562,
"146","3709",泰安市,Taian,2085047,2766209,3249584,2727998,1577851,1733114,1545662,1700362,32189,32752,5334631,5494207,2698364,2742039,2636267,2752168,5191036,5571627,312788,638610,135446,392906,53803,212217,24345,33487,4082804,4120496,1242337,1353946,37,山东省,Shandong,6.41843717601,0.76427943846,
"147","3710",威海市,Weihai,1291155,1632787,1305598,1171984,950454,1047166,922872,1021912,27582,25254,2596753,2804771,1302400,1413199,1294353,1391572,2258372,2543939,454281,625058,132511,214165,104493,180443,140423,230450,1879127,1828741,708018,970852,37,山东省,Shandong,9.57823933794,0.55146408936,
"148","3711",日照市,Rizhao,951867,1318689,1734061,1482324,892068,1011808,876793,988566,15275,23242,2685928,2801013,1350519,1415966,1335409,1385047,2633133,2883629,192482,421610,50945,226590,21941,127851,33503,67169,2202308,2269006,468359,492754,37,山东省,Shandong,4.74155850569,0.52275203712,
"149","3712",莱芜市,Laiwu,486737,668805,746788,629724,406429,452789,397755,446455,8674,6334,1233525,1298529,626549,653394,606976,645135,1162466,1267581,98608,191328,0,148654,14015,34771,4941,7903,896147,889244,336155,405686,37,山东省,Shandong,2.11159742399,0.20922814656,
"150","3713",临沂市,Linyi,2786531,4522930,7156121,5516510,3072789,3335317,3014100,3303932,58689,31385,9942652,10039440,5075129,5103107,4867523,4936333,9695004,10690066,498408,946776,176555,532288,120070,314293,57814,100195,8676880,8681073,1238534,1233392,37,山东省,Shandong,8.53080445834,1.70113505871,
"151","3714",德州市,Dezhou,1492105,2396974,3801569,3171261,1517297,1641170,1492129,1623811,25168,17359,5293674,5568235,2666155,2818739,2627519,2749496,5257684,5760572,200883,389770,88601,277554,30184,64148,26285,48068,4397453,4547772,887500,982000,37,山东省,Shandong,7.43309089555,1.06709429198,
"152","3715",聊城市,Liaocheng,1425249,2134661,3986866,3655202,1539210,1767731,1517494,1753952,21716,13779,5412115,5789863,2711027,2938609,2701088,2851254,5379052,6018686,243474,432399,127002,333123,30964,70100,23789,29176,4692427,4678408,707608,1019082,37,山东省,Shandong,4.69398109221,0.86556416346,
"153","3716",滨州市,Binzhou,869204,1713351,2694717,2035123,1078238,1185337,1061648,1159148,16590,26189,3563921,3748474,1789009,1884028,1774912,1864446,3456099,3772604,215766,406605,79667,256981,44538,109914,18403,39710,3054558,3139125,494783,585447,37,山东省,Shandong,9.25452751742,0.87511838995,
"154","3717",菏泽市,Heze,1689483,2901709,6408490,5385984,2243224,2464850,2227422,2442015,15802,22835,8097973,8287693,4109099,4173547,3988874,4114146,8225033,9482449,247065,405853,123623,328805,23495,49595,25076,27453,7248395,7303837,836146,901533,37,山东省,Shandong,5.6916279867,1.20267038932,
"158","4104",平顶山市,Pingdingshan,1439305,2022420,3365619,2882281,1282480,1353000,1261152,1336013,21328,16987,4804924,4904701,2500998,2523143,2303926,2381558,4563742,5284001,367603,486258,109975,278019,89932,185579,23727,22660,3776749,3730398,1014568,1111067,41,河南省,Henan,5.53375680467,0.77531254983,
"160","4106",鹤壁市,Hebi,485483,744285,916389,824923,363844,404878,355418,401216,8426,3662,1401872,1569208,723612,804272,678260,764936,1315109,1583918,106033,103910,22268,64012,28642,36038,9421,3860,1020524,1054004,369368,485020,41,河南省,Henan,2.73856615487,0.21451379328,
"162","4108",焦作市,Jiaozuo,1284813,1992285,2630481,2223573,983032,1068315,966158,1050845,16874,17470,3915294,4215858,1998547,2140682,1916747,2075176,3625369,4296217,393615,489618,151580,301839,76870,158615,39876,29164,2889506,3022012,977900,1149891,41,河南省,Henan,4.56989123211,0.59597843518,
"163","4109",濮阳市,Puyang,757338,1127083,2700994,2471657,876063,958658,865063,952240,11000,6418,3458332,3598740,1768698,1796273,1689634,1802467,3377108,3814284,151454,277527,37915,161877,54621,97169,21885,18481,2946443,2988981,502740,574986,41,河南省,Henan,4.84671566483,0.4184263226,
"166","4112",三门峡市,Sanmenxia,716830,982693,1460598,1251325,598954,643470,581898,629601,17056,13869,2177428,2234018,1143520,1148433,1033908,1085585,2015873,2245480,198373,196080,64487,118196,68168,62267,33648,15617,1673806,1571879,497113,642305,41,河南省,Henan,6.7541637162,0.971916312,
"169","4115",信阳市,Xinyang,1191525,2087765,5335843,4021341,1938252,1841358,1928519,1825919,9733,15439,6527368,6109106,3355307,3066246,3172061,3042860,7055521,8457648,314005,656499,130950,496868,42904,132346,20402,27285,5505123,4981693,996032,1049076,41,河南省,Henan,8.73524703914,1.80951065001,
"173","4202",黄石市,Huangshi,1223037,1379941,1254430,1049377,630103,698966,612660,683236,17443,15730,2477467,2429318,1300898,1259260,1176569,1170058,2327830,2680114,251604,377015,75877,207475,89589,137748,12575,31792,1602077,1479548,859646,875502,42,湖北省,Hubei,3.7289955661,0.42546385177,
"174","4203",十堰市,Shiyan,1120483,1547637,2295429,1793204,973403,1000705,932222,980327,41181,20378,3415912,3340841,1817856,1751833,1598056,1589008,3259757,3531862,286903,559536,102881,275634,97121,230024,29568,53878,2535014,2395271,868681,906095,42,湖北省,Hubei,9.74977929205,2.26601520334,
"175","4205",宜昌市,Yichang,1593243,2024081,2556065,2035605,1286135,1320054,1247480,1294008,38655,26046,4149308,4059686,2159184,2080389,1990124,1979297,3754459,3998695,546106,631765,168069,287494,171105,251944,107667,92327,2917759,2689532,1214514,1354566,42,湖北省,Hubei,8.14156551923,2.00390737195,
"180","4210",荆州市,Jingzhou,2078666,2416702,4201324,3275005,1682573,1641729,1640781,1618921,41792,22808,6279990,5691707,3229617,2899608,3050373,2792099,6011041,6640654,423484,593209,112218,370636,112446,163779,44657,58794,4858003,4125015,1403317,1472253,42,湖北省,Hubei,9.52382230166,1.31831679951,
"181","4211",黄冈市,Huanggang,1711261,2144138,5397786,4017931,1831897,1797702,1781099,1769281,50798,28421,7109047,6162069,3748884,3178651,3360163,2983418,7021207,7442464,238871,379492,148482,274235,41238,74063,21161,31194,5827870,4919435,1246371,1165580,42,湖北省,Hubei,8.33700771685,1.64000347997,
"184","4228",恩施土家族苗族自治州,Enshitujiazumiaozu,579759,995644,3195431,2294650,1052885,1061392,1031907,1044013,20978,17379,3775190,3290294,1986706,1674095,1788484,1616199,3726996,3975736,116597,310905,79085,219940,19973,57156,15761,33809,3345665,2775993,424258,480615,42,湖北省,Hubei,11.2179750134,2.26519431229,
"185","4290",省直辖行政单位,Hubei (Direct Units),1342683,1634266,2815814,1982149,1029677,1035734,998498,1022738,31179,12996,4158497,3616415,2172446,1878326,1986051,1738089,4025592,4323497,199936,255168,147776,189359,27181,43357,14749,22452,3423672,2803105,723106,784952,42,湖北省,Hubei,8.10647345141,0.98217047783,
"193","4308",张家界市,Zhangjiajie,338025,496265,1155090,981884,438634,446122,433735,438780,4899,7342,1493115,1478149,774069,754897,719046,723252,1496742,1646149,76178,147426,24358,101203,14143,35280,4587,10943,1263969,1162906,226021,301786,43,湖南省,Hunan,5.68711381037,0.88754162298,
"194","4309",益阳市,Yiyang,1183328,1719909,3125815,2588024,1246303,1274536,1229461,1254000,16842,20536,4309143,4307933,2234067,2190041,2075076,2117892,4334947,4759387,179647,306717,96672,213100,30068,72542,10151,21075,3561902,3324173,740068,952039,43,湖南省,Hunan,8.68589003995,1.12320446463,
"198","4313",娄底市,Loudi,952785,1323373,2830448,2461261,1072411,1105983,1056050,1091845,16361,14138,3783233,3784634,1968190,1950231,1815043,1834403,3788487,4323502,213888,403518,95088,232546,65027,152056,13148,18916,3048779,2996322,723734,755424,43,湖南省,Hunan,6.33788117526,0.74324845837,
"199","4331",湘西土家族苗族自治州,Xiangxitujiazumiaozu,487196,885316,1976421,1664242,635975,665193,627033,658248,8942,6945,2463617,2549558,1277391,1307797,1186226,1241761,2476524,2845811,176387,251361,119301,164609,44605,71742,11592,15010,2057003,2055607,396416,463665,43,湖南省,Hunan,7.42517719222,1.43007260022,
"201","4402",韶关市,Shaoguan,1398125,1484761,1337308,1341485,767665,913622,746252,883871,21413,29751,2735433,2826246,1412610,1439912,1322823,1386334,2742729,3248519,400442,537637,115329,234756,110015,180492,107132,122389,1793164,1764262,878129,1019181,44,广东省,Guangdong,9.27943089097,1.63292795592,
"203","4404",珠海市,Zhuhai,1056169,1369538,179268,192992,361503,556240,302230,476615,59273,79625,1235437,1562530,618413,813809,617024,748721,630173,1053186,665825,729225,20499,145453,224207,226084,357269,357688,641641,647241,580125,900978,44,广东省,Guangdong,7.09722394299,0.12005801588,
"205","4406",佛山市,Foshan,4006681,6771895,1331028,425499,1502543,2359068,1161690,1984934,340853,374134,5337709,7197394,2794865,3876536,2542844,3320858,3112546,3719983,2402863,3870373,122042,290243,665710,1077311,1540828,2502819,3839844,5076000,1464847,2082859,44,广东省,Guangdong,4.4793532888,0.3422384473,
"206","4407",江门市,Jiangmen,1866158,2772734,2090669,1677969,1097404,1366783,1047665,1303988,49739,62795,3956827,4450703,1987809,2276607,1969018,2174096,3570909,3955687,682987,1110568,167350,351902,141722,243118,321576,515548,2704891,3005976,1201795,1399096,44,广东省,Guangdong,9.02063703402,0.81373501598,
"208","4409",茂名市,Maoming,1961413,2039585,3277013,3777909,1303981,1540199,1291466,1505873,12515,34326,5238426,5817494,2745217,3023779,2493209,2793715,5834592,7408147,300918,404229,157474,297544,33986,64688,57315,41997,4150905,4443388,885672,1218457,44,广东省,Guangdong,7.72157953984,0.99532599848,
"209","4412",肇庆市,Zhaoqing,1097090,1660083,2276009,2256384,890738,1118112,864220,1070659,26518,47453,3373099,3916467,1704409,2005288,1668690,1911179,3557423,4228670,373906,588075,110821,203338,86526,178974,100007,205763,2612163,2918925,722079,885803,44,广东省,Guangdong,6.69718728518,1.31482806823,
"210","4413",惠州市,Huizhou,1662175,2843738,1553900,1754664,764755,1384016,665650,1209491,99105,174525,3216075,4598402,1621353,2421743,1594722,2176659,2401562,3354253,1117998,2057606,143541,386652,261132,499232,651906,1171722,2247174,3311047,883295,1239547,44,广东省,Guangdong,8.36638561148,1.00100575178,
"211","4414",梅州市,Meizhou,1414895,1823150,2387291,2415311,1001105,1136628,985582,1110636,15523,25992,3802186,4238461,1911728,2123914,1890458,2114547,4205942,5199047,409879,468665,170143,295638,96382,129948,53940,43079,3007716,3196024,736267,952246,44,广东省,Guangdong,7.26667381532,1.40515931845,
"212","4415",汕尾市,Shanwei,1289907,1590341,1163572,1345128,486976,641993,480833,631063,6143,10930,2453479,2935469,1267173,1504665,1186306,1430804,2448546,3324808,208890,256518,71836,159329,34222,36576,51274,60613,1798666,2134910,580500,751183,44,广东省,Guangdong,6.0546294556,0.42304480555,
"213","4416",河源市,Heyuan,601050,1181228,1665379,1768967,574373,741640,565832,711158,8541,30482,2266429,2950195,1143302,1475097,1123127,1475098,2754927,3591517,188032,368659,72913,156887,48096,131796,28864,79976,1811615,2215484,422810,673002,44,广东省,Guangdong,7.5304966721,1.3870025694,
"214","4417",阳江市,Yangjiang,909172,1133702,1259732,1288046,565132,706257,555707,695591,9425,10666,2168904,2421748,1139376,1273345,1029528,1148403,2271497,2766698,246624,302756,67014,193935,52730,67740,47118,41081,1546146,1624504,593015,739721,44,广东省,Guangdong,8.0240053581,0.68100277463,
"215","4418",清远市,Qingyuan,1026722,1758224,2119991,1940188,829284,1072157,814759,1032291,14525,39866,3146713,3698412,1625456,1894516,1521257,1803896,3421996,4164356,311877,693729,118628,327527,69413,178297,64802,187905,2494430,2901846,593178,700787,44,广东省,Guangdong,8.53776907407,1.6858642405,
"216","4419",东莞市,Dongguan,3870036,7271322,2575741,948885,1385164,3170692,716001,2311534,669163,859158,6445777,8220207,3035742,4446224,3410035,3773983,1483472,1854215,5009151,6583474,86543,198172,786063,1052761,4136545,5332541,5726309,7084115,690872,1095511,44,广东省,Guangdong,2.42365741258,0.21133656478,
"218","4451",潮州市,Chaozhou,1042556,1674977,1359512,994489,566704,643025,553669,621640,13035,21385,2402068,2669466,1215765,1355495,1186303,1313971,2316964,2640595,213037,412633,23547,141214,32576,82153,77263,189266,1818061,1990754,553228,638415,44,广东省,Guangdong,3.77559779436,0.27536009915,
"220","4453",云浮市,Yunfu,771753,874803,1381131,1492351,587132,676336,577948,661506,9184,14830,2152884,2367154,1109434,1210330,1043450,1156824,2373482,2813877,138604,205861,64683,110154,24399,51295,32849,44412,1817649,1930265,309514,384070,44,广东省,Guangdong,5.66493419243,0.68517754314,
"226","4506",防城港市,Fangchenggang,286891,418530,449061,448397,192380,231921,189605,224742,2775,7179,735952,866927,407974,476343,327978,390584,719300,860057,78195,163308,23984,62552,24497,71095,10175,29661,539661,617307,181746,214827,45,广西省,Guangxi,6.46725796561,0.51727173992,
"228","4508",贵港市,Guigang,958116,1655929,2869829,2462879,987956,1179237,981369,1169045,6587,10192,3827945,4118808,2019244,2133891,1808701,1984917,4350709,5033101,118997,266757,46091,172736,26484,69316,12627,24705,3405158,3615850,397511,417394,45,广西省,Guangxi,6.30165175067,0.93770607747,
"231","4522",柳州地区,Liuzhoudiqu,632183,696487,2890139,1403224,901002,602213,894113,594341,6889,7872,3522322,2099711,1867738,1087203,1654584,1012508,3775807,2498236,181226,209880,109643,144988,53066,45718,15487,19174,3022823,1768332,480262,297147,45,广西省,Guangxi,15.2622017163,2.37333125985,
"232","4524",贺州地区,Hezhoudiqu,459162,689545,1477687,1264527,456173,502285,452285,495468,3888,6817,1936849,1954072,1027045,1011406,909804,942666,1999635,2231947,73795,135849,47132,73775,14599,42255,12064,19819,1693274,1668487,240707,261894,45,广西省,Guangxi,7.68055334389,1.03711511354,
"233","4526",百色地区,Baisediqu,589495,886050,2742601,2580708,869455,978348,859842,963356,9613,14992,3332096,3466758,1731358,1782226,1600738,1684532,3539107,3826277,172207,334886,70809,185045,74013,110073,25959,39768,2901996,2955859,425533,439180,45,广西省,Guangxi,14.7407541281,3.21564815142,
"234","4527",河池地区,Hechidiqu,780949,888199,2742744,2481052,939972,1003127,924448,988334,15524,14793,3523693,3369251,1854975,1729426,1668718,1639825,3632749,3991899,195129,305409,76171,169713,89105,106689,29853,29007,3028512,2866719,479754,438046,45,广西省,Guangxi,12.1096996404,2.97945328239,
"235","4601",海口市,Haikou,757640,1517410,72552,528760,241494,607982,218912,549454,22582,58528,830192,2046170,431774,1060095,398418,986075,510998,1459948,344220,901628,4181,163168,127258,434246,161616,304214,285382,997577,534417,1020988,46,海南省,Hainan,0.87470598769,0.01771126081,
"236","4602",三亚市,Sanya,309848,453819,172448,231589,106241,174512,101420,152524,4821,21988,482296,685408,254293,362796,228003,322612,406403,564001,92552,238489,7349,38302,23168,78859,42903,121328,299110,400969,177968,272301,46,海南省,Hainan,3.23907989308,0.15700812689,
"237","4690",模拟地区,Munidiqu,2007160,2337287,4239387,3602620,1459786,1669325,1430378,1629171,29408,40154,6246547,5939907,3316378,3169392,2930169,2770515,6067939,6461956,541376,703313,228913,384962,121896,155430,177273,162921,4554181,4137754,1631965,1682824,46,海南省,Hainan,15.279107658,2.73230230883,
"241","5103",自贡市,Zigong,860349,1098902,2173414,1579997,869440,847777,860526,836231,8914,11546,3033763,2678899,1554210,1339594,1479553,1339305,2978545,3254658,188386,274870,59988,142314,32171,119196,6503,13360,2323754,1883254,696732,781384,51,四川省,Sichuan,4.80970967581,0.4060671537,
"242","5104",攀枝花市,Panzhihua,610661,729740,480996,484381,333402,389955,318927,378764,14475,11191,1091657,1214121,571169,628899,520488,585222,973526,1117929,163386,320940,16306,77507,98676,200665,15386,42768,572910,670617,510499,531758,51,四川省,Sichuan,5.67103391216,0.67451312657,
"245","5107",绵阳市,Mianyang,1684709,1838667,3485432,2775204,1615859,1714149,1578380,1672203,37479,41946,5170141,4613871,2680950,2336711,2489191,2277160,5050490,5375401,387021,703375,108987,276204,151963,370773,21566,56398,4147285,3235002,998701,1353400,51,四川省,Sichuan,10.5141718505,1.92741587842,
"246","5108",广元市,Guangyuan,735489,819206,2327802,1664916,853089,844593,838963,831175,14126,13418,3063291,2484122,1589176,1251498,1474115,1232624,2950116,3094117,177928,274824,65012,150320,44876,97914,11934,26590,2504218,1864588,537931,609829,51,四川省,Sichuan,8.12222289556,1.55194981062,
"247","5109",遂宁市,Suining,892445,1199558,2584568,2053061,982551,1041338,960209,1027409,22342,13929,3477013,3252619,1785548,1642115,1691465,1610504,3510233,3786833,289685,258749,57683,188083,29516,59206,124067,11460,2963271,2423402,500701,813470,51,四川省,Sichuan,3.87099042055,0.5013740686,
"248","5110",内江市,Neijiang,1189181,1401041,2971124,2301806,1207492,1211653,1192546,1203038,14946,8615,4160305,3702847,2133828,1878205,2026477,1824642,4030775,4278501,313557,267857,169541,171739,54030,81157,11858,14961,3461011,2897317,688568,771848,51,四川省,Sichuan,4.82142135336,0.50415653878,
"249","5111",乐山市,Leshan,865753,1277315,2458386,1958444,1031318,1084807,1008939,1065594,22379,19213,3324139,3235759,1708354,1631205,1615785,1604554,3297313,3542882,256001,421473,87007,234604,77950,158271,11181,28598,2555563,2213560,756744,1000425,51,四川省,Sichuan,7.21635663831,1.19469805729,
"252","5115",宜宾市,Yibin,1202136,1500544,3685106,2971352,1366237,1436723,1343212,1419153,23025,17570,4887242,4471896,2555872,2299731,2331370,2172165,4862819,5406434,517492,462756,289519,250493,97867,180889,17127,31374,4082934,3480211,758777,872448,51,四川省,Sichuan,7.31348248052,1.22350156115,
"254","5117",达州市,Dazhou,895104,1788418,4898040,3679679,1647384,1694365,1619424,1674174,27960,20191,5793144,5468097,3024622,2795541,2768522,2672556,5943931,6827251,327895,530101,177256,355358,84183,140693,19051,34050,4919668,4240486,822532,1168802,51,四川省,Sichuan,8.91959108761,1.56835650935,
"255","5118",雅安市,Yaan,355171,521764,1167674,985494,450902,470139,444039,462031,6863,8108,1522845,1507258,789584,766602,733261,740656,1454159,1550002,125736,167198,56112,95584,35920,56490,5249,15124,1237436,1146331,275487,347418,51,四川省,Sichuan,7.68582004756,1.40565032825,
"257","5120",资阳市,Ziyang,780412,1126046,3917262,2539011,1405675,1322979,1393179,1308624,12496,14355,4697674,3665057,2430315,1846908,2267359,1818149,4818561,5027842,121752,278346,63326,219954,21396,43590,7554,14802,4163192,2935768,521984,702893,51,四川省,Sichuan,5.28453686275,0.74346056873,
"258","5132",阿坝藏族羌族自治州,Abacangzuqiangzu,152658,270473,694810,628235,202463,230550,197406,224083,5057,6467,847468,898708,437949,467224,409519,431484,804897,901679,54535,113925,22093,44013,28151,56126,4291,13786,701346,716505,141912,177711,51,四川省,Sichuan,20.8540839169,7.90015368499,
"259","5133",甘孜藏族自治州,Ganzicangzu,133691,209863,763548,882009,203927,263119,198990,251861,4937,11258,897239,1091872,456161,563642,441078,528230,872168,1057212,47961,138099,19792,50242,23322,65573,4847,22284,769871,924346,121528,151346,51,四川省,Sichuan,29.0888597456,13.9751001023,
"260","5134",凉山彝族自治州,Liangshanyizu,598019,1247552,3483678,3285257,1052724,1202425,1040347,1182922,12377,19503,4081697,4532809,2126003,2344030,1955694,2188779,3994691,4798037,176188,603881,85739,343730,76554,215405,13895,44746,3584957,3892155,449347,503076,51,四川省,Sichuan,20.2644404262,5.49568069593,
"262","5202",六盘水市,Liupanshui,633292,816603,2110793,2034729,719644,907963,711581,889146,8063,18817,2744085,2851332,1448013,1493973,1296072,1357359,2718237,3148301,179729,381630,26584,165746,73595,152801,33874,63083,2178909,2112150,512273,682045,52,贵州省,Guizhou,6.88839223325,0.89884804756,
"263","5203",遵义市,Zunyi,1502148,2145615,5041712,3981467,1781709,1972234,1767650,1944757,14059,27477,6543860,6127082,3396536,3116640,3147324,3010442,6805672,7659058,454542,879785,122520,451102,144673,317802,61241,110881,5609851,4822524,891864,1182422,52,贵州省,Guizhou,13.3417952541,2.82793327884,
"264","5204",安顺市,Anshun,603361,690665,1728380,1606947,602158,675915,597131,667159,5027,8756,2331741,2297612,1218376,1186013,1113365,1111599,2371610,2768651,164175,262660,29393,136400,47627,83601,22147,42659,1928286,1836889,348183,388756,52,贵州省,Guizhou,6.39062417925,0.84030695856,
"265","5222",铜仁地区,Tongrendiqu,531433,803990,2771192,2289214,919169,990072,915972,979494,3197,10578,3302625,3093204,1716957,1577421,1585668,1515783,3673914,4189425,68944,221238,39291,139129,13983,46137,13307,35972,2982410,2639012,315537,437940,52,贵州省,Guizhou,10.1461867257,1.64169286319,
"266","5223",黔西南布依族苗族自,Qianxinanbuyizumiaozu,598738,788833,2266182,2015779,710736,813932,705788,802666,4948,11266,2864920,2804612,1488175,1439828,1376745,1364784,2907078,3324274,120660,267118,65171,149185,30171,67768,21373,50165,2581870,2437892,252477,306208,52,贵州省,Guizhou,7.87583591325,1.50470819334,
"267","5224",毕节地区,Bijiediqu,796806,1710465,5530665,4827033,1593346,1873591,1589009,1854772,4337,18819,6327471,6537498,3337085,3387605,2990386,3149893,6615901,8337362,157246,454514,105089,301708,32241,82357,19916,70449,5853304,5811341,384777,519445,52,贵州省,Guizhou,11.144904101,2.43780441969,
"268","5226",黔东南苗族侗族自治,Qiandongnanmiaozudongzu,690525,918935,3154172,2562956,990753,1088418,983468,1072872,7285,15546,3844697,3481891,2035112,1817730,1809585,1664161,4072507,4457867,172841,358365,93435,182109,49005,111543,28989,64713,3414824,2965613,417449,483833,52,贵州省,Guizhou,12.558558521,2.7443030006,
"269","5227",黔南布依族苗族自治,Qiannanbuyizumiaozu,814467,930142,2755380,2302572,912027,989256,903907,977040,8120,12216,3569847,3232714,1869404,1664365,1700443,1568349,3670691,3980083,168912,290890,91754,163384,38674,74759,38484,52747,3096044,2670375,456276,501860,52,贵州省,Guizhou,13.0377033755,2.34879174677,
"271","5303",曲靖市,Qujing,1029608,2297938,4436481,3557117,1486109,1647261,1466866,1618821,19243,28440,5466089,5855055,2898018,3074983,2568071,2780072,5364208,6274370,259272,557858,79716,334612,86271,139640,76344,83606,4790180,5089583,604727,677378,53,云南省,Yunnan,10.8871339786,2.59761741487,
"273","5321",昭通地区,Zhaotongdiqu,513621,975284,4078767,4238237,1157315,1291599,1152447,1277565,4868,14034,4592388,5213521,2404737,2738001,2187651,2475520,4803807,5829505,94822,292061,49244,171812,16602,58556,28976,61693,4165397,4639872,333654,430014,53,云南省,Yunnan,10.5589903411,2.057791423,
"274","5323",楚雄彝族自治州,Chuxiongyizu,516632,857721,2025898,1826448,689470,738961,676837,721989,12633,16972,2542530,2684169,1313547,1374454,1228983,1309715,2451958,2638153,155710,280191,62706,127969,49326,103840,43678,48382,2205487,2275914,324303,393464,53,云南省,Yunnan,9.71541807735,2.55011902739,
"275","5325",红河哈尼族彝族自治州,Honghehanizuyizu,1056184,1380437,3074279,3120459,1061881,1191076,1040276,1168050,21605,23026,4130463,4500896,2164378,2341328,1966085,2159568,3908860,4460511,328717,494010,102952,183293,141446,216044,84319,94673,3410383,3731806,679349,731986,53,云南省,Yunnan,13.13733812,2.83441142514,
"276","5326",文山壮族苗族自治州,Wenshanzhuangzumiaozu,496968,808283,2771585,2709663,761865,825702,755436,815164,6429,10538,3268553,3517946,1727927,1838545,1540626,1679401,3236766,3697726,93129,254064,36128,132843,25008,71626,31993,49595,2991802,3130930,255322,332225,53,云南省,Yunnan,10.2664006801,2.78509799982,
"277","5327",思茅地区,Simaodiqu,453785,669340,2026561,1873558,613771,702778,594952,689342,18819,13436,2480346,2542898,1343491,1339502,1136855,1203396,2338935,2506730,212323,335998,72928,129485,89692,149755,49703,56758,2101926,2184047,280189,329833,53,云南省,Yunnan,14.1364307824,3.89031825432,
"278","5328",西双版纳傣族自治州,Xishuangbannadaizu,228862,385093,764535,748422,265688,323623,260464,314020,5224,9603,993397,1133515,515982,587386,477415,546129,846816,945259,174507,295347,19074,44083,104675,179863,50758,71401,729872,846606,253893,265843,53,云南省,Yunnan,7.98326101571,1.67576863298,
"279","5329",大理白族自治州,Dalibaizu,623606,1121395,2672946,2334928,856791,937768,845046,918419,11745,19349,3296552,3456323,1682926,1751987,1613626,1704336,3231557,3522611,161200,264869,61595,109098,55094,97068,44511,58703,2901871,3007101,380687,438336,53,云南省,Yunnan,10.9612992096,2.55384332251,
"280","5330",保山地区,Baoshandiqu,232569,572053,2115746,1934438,572461,626476,559571,616285,12890,10191,2348315,2506491,1209674,1285247,1138641,1221244,2320313,2549381,83131,170536,35878,96338,26605,41720,20648,32478,2104950,2213897,227272,272940,53,云南省,Yunnan,8.50038315011,1.70505508815,
"281","5331",德宏傣族景颇族自治州,Dehongdaizujingpozu,471393,413393,611206,798047,263311,326112,257191,315547,6120,10565,1082599,1211440,555066,624774,527533,586666,1010401,1150313,109425,212938,33860,68456,47348,97746,28217,46736,882253,960972,183817,215731,53,云南省,Yunnan,6.17935680861,0.99469220976,
"282","5332",丽江地区,Lijiangdiqu,184204,355750,942442,889019,283340,321846,275727,312668,7613,9178,1126646,1244769,578412,642374,548234,602395,1091547,1209381,60219,164902,22100,55721,14942,62502,23177,46679,988077,1068158,133753,171780,53,云南省,Yunnan,9.67237162573,1.8697843971,
"283","5333",怒江傈僳族自治州,Nujianglisuzu,72353,124965,419471,409372,119498,142290,116618,139018,2880,3272,491824,534337,267031,282900,224793,251437,471663,530974,29427,56619,5738,17812,13013,22813,10676,15994,410749,443650,62196,74846,53,云南省,Yunnan,10.6985456359,1.32727103063,
"284","5334",迪庆藏族自治州,Diqingcangzu,56357,99612,297161,300570,79808,95780,77852,91579,1956,4201,353518,400182,184451,213073,169067,187109,331434,358216,25601,63734,6706,14575,11053,28849,7842,20310,310588,346580,41312,48858,53,云南省,Yunnan,11.4249333089,2.12114109718,
"285","5335",临沧地区,Lincangdiqu,212635,591205,2119935,1838292,532600,606400,522256,596484,10344,9916,2332570,2429497,1249218,1274678,1083352,1154819,2230228,2377101,131586,193104,45250,91217,46631,63524,39705,38363,2031685,2144290,195170,263401,53,云南省,Yunnan,8.50894720218,2.09852034227,
"286","5401",拉萨市,Lasa,190532,240958,283967,318465,123392,162463,116705,153632,6687,8831,474499,559423,242442,287437,232057,271986,380191,472364,113302,128393,14685,428,27502,48450,51523,79515,323193,366911,147460,187471,54,西藏,Xizang,10.0215253992,2.76708657002,
"287","5421",昌都地区,Changdudiqu,53034,85263,533118,572242,99049,115908,97030,113833,2019,2075,586152,657505,297181,338097,288971,319408,578113,659480,26743,23598,8334,468,2391,5479,14430,17651,548844,592572,35170,41128,54,西藏,Xizang,27.0654844039,10.2416511566,
"288","5422",山南地区,Shannandiqu,99062,71957,219044,257033,75734,89276,74746,87998,988,1278,318106,328990,158783,166270,159323,162720,315422,327994,13494,18368,2801,34,3029,5358,6966,12976,286548,288835,26634,35377,54,西藏,Xizang,16.0924846655,7.30788445199,
"289","5423",日喀则地区,Rikazediqu,85950,123734,549012,579558,120574,147766,119268,145401,1306,2365,634962,703292,322123,361611,312839,341681,638987,721154,19356,25629,4199,56,4186,9400,9909,16173,576147,612304,58037,83150,54,西藏,Xizang,38.0535325469,16.8979985614,
"290","5424",那曲地区,Naqudiqu,25661,75284,341049,387097,70044,99074,69267,98035,777,1039,366710,462381,183380,239023,183330,223358,357688,457918,13658,21904,3686,67,2904,12189,6484,9648,337828,418165,27988,40238,54,西藏,Xizang,46.9421785379,37.8709025548,
"291","5425",阿里地区,Alidiqu,14687,21910,62566,73555,18210,23946,17835,22962,375,984,77253,95465,39641,49802,37612,45663,73246,89741,4892,7113,645,125,1446,2575,2697,4413,67794,80264,9236,14651,54,西藏,Xizang,39.6159334051,28.6113047451,
"292","5426",林芝地区,Linzhidiqu,39400,61483,119247,133626,37906,51088,36720,48977,1186,2111,158647,195109,81821,100412,76826,94697,140076,165255,22332,37000,1917,384,3039,11569,16660,25047,129645,158243,28074,34269,54,西藏,Xizang,25.4081971515,10.6341472251,
"294","6102",铜川市,Tongchuan,403956,483058,388644,351379,226811,257533,220401,253315,6410,4218,792600,834437,416829,432203,375771,402234,760045,843514,73223,95952,19193,46378,21954,39429,9124,10145,462836,450396,323577,380748,61,陕西省,Shaanxi,3.30525028727,0.38782661646,
"295","6103",宝鸡市,Baoji,1055647,1538015,2538568,2178722,996738,1046357,958455,1028578,38283,17779,3594215,3716737,1861050,1918290,1733165,1798447,3575950,3778039,178227,341252,66436,187661,40547,111159,23459,42432,2758017,2779780,775543,917875,61,陕西省,Shaanxi,8.00402440864,1.77944906582,
"297","6105",渭南市,Weinan,1143636,1669297,4148564,3616780,1380610,1469833,1338408,1445151,42202,24682,5292200,5286077,2704108,2682710,2588092,2603367,5238236,5522602,237573,407246,140121,321227,47612,56919,22537,29100,4414160,4274908,813276,983583,61,陕西省,Shaanxi,7.19200088501,1.29871361302,
"299","6107",汉中市,Hanzhong,923993,1266588,2487051,2149608,1045557,1108229,1028619,1093481,16938,14748,3411044,3416196,1776346,1756525,1634698,1659671,3588625,3800333,118712,341781,39530,221177,36914,79193,19512,41411,2783147,2704023,608627,695211,61,陕西省,Shaanxi,10.6835485981,2.61977546132,
"300","6108",榆林市,Yulin,691639,1588868,2446401,1762568,821957,1018826,805538,988769,16419,30057,3138040,3351436,1635150,1769701,1502890,1581735,2991938,3675349,302570,1027379,172169,590594,62562,320696,27169,116089,2670506,2690632,442031,626061,61,陕西省,Shaanxi,17.6064352886,4.43084413323,
"301","6109",安康市,Ankang,486940,909828,2126974,1720078,758418,779886,750126,773547,8292,6339,2613914,2629906,1392883,1389650,1221031,1240256,2805813,3022081,90587,182989,39059,132089,11037,26649,25999,24251,2266671,2199219,340685,403034,61,陕西省,Shaanxi,9.88136365872,2.25157123691,
"302","6125",商洛地区,Shangluodiqu,381587,640104,1963850,1701638,639350,639823,626243,631571,13107,8252,2345437,2341742,1246982,1231944,1098455,1109798,2382175,2425060,66804,146956,39658,114420,9084,20340,15805,12196,2116476,1989875,221844,335543,61,陕西省,Shaanxi,8.39743529031,1.90768251316,
"304","6202",嘉峪关市,Jiayuguan,136465,216362,23076,15491,53589,83474,51729,80320,1860,3154,159541,231853,85959,123806,73582,108047,135796,208279,33172,74719,23,30552,16262,29359,8474,14808,41615,55256,117304,174924,62,甘肃省,Gansu,1.88557926472,0.13676370173,
"305","6203",金昌市,Jinchang,244819,288171,206751,175879,136445,161708,131461,158043,4984,3665,451570,464050,235792,241691,215778,222359,399370,459182,67579,97532,13255,50674,25638,36676,9987,10182,261160,255647,187753,203158,62,甘肃省,Gansu,4.63294404024,0.76189054064,
"306","6204",白银市,Baiyin,458026,672846,1261709,1035906,406975,458994,396397,447600,10578,11394,1719735,1708752,888032,877941,831703,830811,1650554,1794877,105792,214634,29694,144153,36038,60760,9426,9721,1360187,1263936,345631,430091,62,甘肃省,Gansu,8.76258315132,2.01645080904,
"307","6205",天水市,Tianshui,572376,918237,2646947,2344312,739610,831775,728688,815229,10922,16546,3219323,3262549,1657849,1645317,1561474,1617232,3334382,3700247,40265,225545,16310,126956,6929,83911,7225,14678,2796465,2462354,411648,765455,62,甘肃省,Gansu,7.73424052545,1.39960621002,
"308","6221",酒泉地区,Jiuquandiqu,495481,555195,485011,540752,300127,352293,289218,342074,10909,10219,980492,1095947,511415,565860,469077,530087,858322,1008211,171211,242548,65625,81085,68904,85528,33312,75935,644109,705344,331406,374383,62,甘肃省,Gansu,24.5252851158,15.4790177256,
"309","6222",张掖地区,Zhangyediqu,348309,414113,903445,785402,345612,367272,334422,359228,11190,8044,1251754,1199515,642370,612594,609384,586921,1194610,1309491,103047,146702,68331,101166,24619,35398,8632,10138,1009542,882124,229758,308872,62,甘肃省,Gansu,17.0463312549,4.11125001659,
"310","6223",武威地区,Wuweidiqu,370008,499346,1466978,1315713,460909,473971,447111,467040,13798,6931,1836986,1815059,949051,933487,887935,881572,1847401,1914895,92640,122520,62242,79643,16163,33916,7398,8961,1553985,1494590,270738,305501,62,甘肃省,Gansu,13.3615412609,3.37030528729,
"311","6224",定西地区,Dingxidiqu,257184,625011,2563065,2073613,655733,711468,644532,702558,11201,8910,2820249,2698624,1460151,1373166,1360098,1325458,2866296,2984982,36909,131349,25186,79593,7695,39075,3683,12681,2578666,2372975,222096,304410,62,甘肃省,Gansu,10.9524931236,1.94669042138,
"312","6226",陇南地区,Longnandiqu,211164,490582,2374315,2077136,608531,668455,600326,660598,8205,7857,2585479,2567718,1362613,1336964,1222866,1230754,2605005,2811960,72447,123266,47402,77797,11923,21294,11452,24175,2371512,2218434,210104,327479,62,甘肃省,Gansu,11.7234624744,2.71981335337,
"313","6227",平凉地区,Pingliangdiqu,298121,597006,1768981,1471027,509921,568009,501166,549633,8755,18376,2067102,2068033,1064064,1040622,1003038,1027411,2128276,2318202,68952,152907,37903,103004,19911,38886,8367,11017,1778421,1671562,271266,378254,62,甘肃省,Gansu,8.8420367062,1.09909645585,
"315","6229",临夏回族自治州,Linxiahuizu,169677,466886,1658785,1479791,386078,454991,382212,446796,3866,8195,1828462,1946677,947729,985235,880733,961442,1843290,2115456,26183,154802,13639,84023,8329,58320,4021,12459,1639160,1575318,178419,326846,62,甘肃省,Gansu,5.14054129597,0.80431293816,
"316","6230",甘南藏族自治州,Gannancangzu,68915,166092,571191,523040,148064,169125,143304,163436,4760,5689,640106,689132,329222,355270,310884,333862,627419,726981,32619,46433,11781,18517,16934,22811,3836,5105,536865,551356,99493,131683,62,甘肃省,Gansu,17.8329540562,3.6121272349,
"317","6301",西宁市,Xining,1024750,1406894,824963,801814,506568,673472,493181,646837,13387,26635,1849713,2208708,957071,1136779,892642,1071929,1655070,1950197,273475,612385,29626,134906,81044,293172,67353,184307,1042838,1234027,783248,956710,63,青海省,Qinghai,4.93905476602,0.72891058404,
"318","6321",海东地区,Haidongdiqu,177673,318915,1213892,1077930,321777,352450,317067,346533,4710,5917,1391565,1396845,715998,717019,675567,679826,1414889,1626874,56118,104403,34503,66675,12571,18553,8767,19175,1235521,1207507,143803,172414,63,青海省,Qinghai,6.37016673418,1.30706084678,
"319","6322",海北藏族自治州,Haibeicangzu,55005,89597,203917,183707,60997,75892,59781,74354,1216,1538,258922,273304,134801,141316,124121,131988,249353,286469,20217,32214,7362,15564,9272,9915,3474,6735,202916,212165,53382,58697,63,青海省,Qinghai,14.8994008874,3.5665655921,
"320","6323",黄南藏族自治州,Huangnancangzu,30794,65960,183848,190756,47943,64764,46552,62950,1391,1814,214642,256716,108393,130194,106249,126522,206559,251534,14565,28898,5070,16196,5880,7258,3483,5444,179377,212811,33279,41284,63,青海省,Qinghai,9.6754054705,1.76123717348,
"321","6325",海南藏族自治州,Hainancangzu,37329,125742,338097,315949,84377,118817,82459,115358,1918,3459,375426,441691,191050,225965,184376,215726,362203,443955,28662,61747,12776,31533,11081,19860,4582,10354,304468,353663,67477,80895,63,青海省,Qinghai,11.5778320203,4.29687619895,
"322","6326",果洛藏族自治州,Guoluocangzu,12869,44918,125071,136764,31877,53545,31438,51383,439,2162,137940,181682,70863,95385,67077,86297,130829,178910,10942,27824,3835,12214,4258,9108,2753,6502,114979,156284,18993,22170,63,青海省,Qinghai,17.9692487051,7.50434756304,
"323","6327",玉树藏族自治州,Yushucangzu,25960,121522,236701,256917,52223,92941,51734,92091,489,850,262661,378439,131701,194762,130960,183677,248681,381205,19972,75876,12698,46792,4375,17331,2762,11753,227421,334098,28667,34350,63,青海省,Qinghai,31.7033296989,19.3329334035,
"324","6328",海西蒙古族藏族,Haiximengguzucangzu,195093,342706,137001,146632,96864,154754,91765,139533,5099,15221,332094,489338,179713,272373,152381,216965,249820,402121,98084,197607,7562,28108,55582,95334,31133,74165,178125,288569,147324,194982,63,青海省,Qinghai,41.1353133131,32.8651128745,
"326","6402",石嘴山市,Shizuishan,406841,497996,268537,227486,204810,254350,200676,248285,4134,6065,675378,725482,350597,374579,324781,350903,612910,742443,104759,196136,27867,93338,22742,49740,34763,53058,314156,329266,356465,393027,64,宁夏省,Ningxia,3.76269882799,0.45779596726,
"327","6403",吴忠市,Wuzhong,563199,799159,1342842,1555465,477561,680918,471943,670539,5618,10379,1906041,2354624,975958,1202872,930083,1151752,1791487,2518668,178505,416925,78736,239262,47223,126522,39083,51141,1472361,1733696,400681,588196,64,宁夏省,Ningxia,10.8469532282,2.76787397059,
"328","6422",固原地区,Guyuandiqu,155727,279462,1571634,948694,375653,328911,372878,322760,2775,6151,1727361,1228156,881585,619390,845776,608766,1759695,1501337,63801,158593,44136,109129,12708,36858,6957,12606,1543739,1026402,152516,180932,64,宁夏省,Ningxia,8.74367019387,1.68048372335,
"329","6501",乌鲁木齐市,Wulumuqi,1738876,2865395,342958,247164,681727,1206030,635874,1133835,45853,72195,2081834,3112559,1090387,1610775,991447,1501784,1389884,1977692,774336,1499122,10815,192936,227999,619798,374525,686388,614810,1021553,1446573,2055894,65,新疆,Xinjiang,7.45444246523,1.29550620999,
"330","6502",克拉玛依市,Kelamayi,270232,353299,0,37709,95937,151858,91353,144730,4584,7128,270232,391008,143500,203310,126732,187698,214137,322021,59767,125496,188,18170,19204,31012,37620,76314,47338,90059,221726,299100,65,新疆,Xinjiang,6.17086835669,0.8962153419,
"331","6521",吐鲁番地区,Tulufandiqu,208428,197213,342303,425690,130851,173607,127894,168699,2957,4908,550731,622903,283888,327854,266843,295049,489673,583982,69028,106784,24519,35695,9929,24219,33797,46870,423811,457796,122315,157962,65,新疆,Xinjiang,13.466068286,7.56710018121,
"332","6522",哈密地区,Hamidiqu,253349,344305,238747,228095,148177,203746,145257,196865,2920,6881,492096,572400,254129,300886,237967,271514,440286,542314,67287,150227,25479,57119,6428,24831,34965,68277,258704,249000,230873,321504,65,新疆,Xinjiang,16.5704742086,15.0773914715,
"333","6523",昌吉回族自治州,Changjihuizu,581464,705624,921633,722963,441036,558990,427580,543860,13456,15130,1503097,1428587,786932,757038,716165,671549,1259295,1461842,327477,357477,110309,139684,52450,77515,163572,140278,1030837,725259,461013,694839,65,新疆,Xinjiang,19.6183335405,8.75642760389,
"334","6527",博尔塔拉蒙古自治州,Boertalamenggu,121478,176260,302562,267420,117298,152454,115546,148886,1752,3568,424040,443680,219745,229399,204295,214281,343092,417062,97389,92356,32325,35036,10056,15547,54425,41773,319669,216347,99597,224798,65,新疆,Xinjiang,9.96153346187,2.85238367022,
"335","6528",巴音郭楞蒙古自治州,Bayinguolengmenggu,373977,623866,682993,654620,312547,432033,302848,420335,9699,11698,1056970,1278486,552524,664714,504446,613772,867442,1095875,224761,321958,56244,79615,32924,69906,133250,172437,690861,685328,355831,584998,65,新疆,Xinjiang,41.7377870418,49.4572780687,
"336","6529",阿克苏地区,Akesudiqu,479719,764978,1662026,1605831,538651,679818,529398,666921,9253,12897,2141745,2370809,1114422,1225608,1027323,1145201,1892798,2245274,283354,332087,76091,129577,26779,62916,176582,139594,1686616,1611776,440263,677324,65,新疆,Xinjiang,18.5529608443,14.0444209751,
"337","6530",克孜勒苏柯尔克孜自治州,Kezilesukeerkezi,74070,104454,365618,421116,95035,127213,94106,125540,929,1673,439688,525570,225067,267660,214621,257910,414211,544722,31553,28805,19927,13986,4466,7576,6565,7243,345617,391890,91061,121257,65,新疆,Xinjiang,22.588635299,7.46194876871,
"338","6531",喀什地区,Kashendiqu,560656,814239,2845057,3165082,783844,982144,776511,968587,7333,13557,3405713,3979321,1743674,2015637,1662039,1963684,3245718,3916265,198401,256556,78201,132400,31513,62166,85457,61990,2782655,3079672,597405,758829,65,新疆,Xinjiang,26.8176682129,11.666708132,
"339","6532",和田地区,Hetiandiqu,242402,255605,1438908,1758757,409704,543380,407675,540974,2029,2406,1681310,2014362,862793,1028276,818517,986086,1608579,2029878,84076,111899,58951,71531,12976,22318,11298,18050,1468279,1676217,201573,279594,65,新疆,Xinjiang,25.8552849043,25.2559770925,
"340","6540",伊犁哈萨克自治州,Yilihasake,585830,896875,1782046,1585717,589227,762163,578858,746283,10369,15880,2367876,2482592,1218411,1276240,1149465,1206352,2150250,2551682,294944,364533,117419,170005,43132,94693,129831,99835,1733766,1547649,606961,904349,65,新疆,Xinjiang,17.5040753658,6.26507298789,
"341","6542",塔城地区,Tachengdi,281137,515582,611260,703787,236864,463940,232699,455160,4165,8780,892397,1219369,463175,644316,429222,575053,786916,1257695,146901,212213,75467,101131,14843,29686,55803,81396,626113,585229,258107,628323,65,新疆,Xinjiang,24.8588535319,11.0633044001,
"342","6543",阿勒泰地区,Aletaidi,176970,229218,384697,374065,138157,200221,136171,197802,1986,2419,561667,603283,288281,313716,273386,289567,550874,643047,24814,66886,6220,32213,3428,14370,14471,20303,343332,326474,215888,275073,65,新疆,Xinjiang,19.4570226573,13.875692167,
"343","6590",直辖行政单位,Xinjiang (Direct Units),298885,488839,291230,282047,197592,265253,192056,247130,5536,18123,590115,770886,305253,404718,284862,366168,479276,666299,145611,250552,36350,56793,9768,62865,98925,130894,397223,164434,188719,590790,65,新疆,Xinjiang,1.08777200262,0.05527657884,
