Incident ID,Incident Date,State,City Or County,Address,# Killed,# Injured,total
946496,1-Oct-17,Nevada,Las Vegas,3950 Las Vegas Blvd S,59,441,500
577157,12-Jun-16,Florida,Orlando,1912 S Orange Ave,50,53,103
980577,5-Nov-17,Texas,Sutherland Springs,216 4th St,27,20,47
1466705,3-Aug-19,Texas,El Paso,7101 Gateway Blvd,23,23,46
456893,2-Dec-15,California,San Bernardino,1365 South Waterman Ave,16,19,35
1049217,14-Feb-18,Florida,Pompano Beach (Parkland),5901 Pine Island Rd,17,17,34
1492441,31-Aug-19,Texas,Odessa,8250 TX 191,8,23,31
1119336,14-Dec-12,Connecticut,Sandy Hook,12 Dickenson Dr,28,2,30
2257739,19-Mar-22,Arkansas,Dumas,611 Highway 65 S,1,26,27
1467828,4-Aug-19,Ohio,Dayton,419 E 5th St,10,17,27
341622,17-May-15,Texas,Waco,4671 S Jack Kultgen Fwy,9,18,27
2310278,24-May-22,Texas,Uvalde,715 Old Carrizo Rd,20,6,26
879953,1-Jul-17,Arkansas,Little Rock,220 W 6th St,0,25,25
2019622,30-May-21,Florida,Hialeah,7630 NW 186th St,3,20,23
1118785,18-May-18,Texas,Santa Fe,16000 Hwy 6,10,13,23
1758966,9-Aug-20,District of Columbia,Washington,3300 block of Dubois Pl SE,1,21,22
1460448,28-Jul-19,California,Gilroy,7050 Miller Ave,4,17,21
611479,25-Jul-16,Florida,Fort Myers,3580 Evans Ave,2,19,21
1142789,17-Jun-18,New Jersey,Trenton,635 S Clinton Ave,1,19,20
121031,2-Apr-14,Texas,Fort Hood,Motor Pool Road and Tank Destroyer Boulevard,4,16,20
1635750,7-Mar-20,Ohio,Cleveland,3804 E 93rd St,1,18,19
423223,1-Oct-15,Oregon,Roseburg,1140 Umpqua College Rd,10,9,19
486209,12-May-13,Louisiana,New Orleans,1400 block of Frenchmen St,0,19,19
2269082,3-Apr-22,California,Sacramento,J St and 10th St,6,12,18
1241819,27-Oct-18,Pennsylvania,Pittsburgh,5898 Wilkins Ave,11,7,18
987611,14-Nov-17,California,Corning,17357 Stagecoach Rd,6,12,18
511436,25-Feb-16,Kansas,Hesston,200 S Ridge Rd,4,14,18
493842,9-Nov-13,Texas,Cypress,7300 block of Enchanted Creek Drive,2,16,18
2301494,13-May-22,Wisconsin,Milwaukee,Water St and Juneau Ave,0,17,17
2269100,3-Apr-22,Texas,Dallas,5050 Cleveland Rd,1,16,17
1600787,19-Jan-20,Missouri,Kansas City,4802 Noland Rd,2,15,17
1410442,31-May-19,Virginia,Virginia Beach,2405 Courthouse Drive,13,4,17
803054,26-Mar-17,Ohio,Cincinnati,4601 Kellogg Ave,2,15,17
451495,22-Nov-15,Louisiana,New Orleans,1900 block of Gallier St,0,17,17
2237593,19-Feb-22,Missouri,Charleston,106 S Franklin St,2,14,16
2137198,10-Oct-21,Minnesota,Saint Paul,214 7th St W,1,15,16
2123395,23-Sep-21,Tennessee,Collierville,240 New Byhalia Rd,2,14,16
1978635,15-Apr-21,Indiana,Indianapolis,8951 Mirabel Rd,9,7,16
1799307,19-Sep-20,New York,Rochester,278 Pennsylvania Ave,2,14,16
1033262,23-Jan-18,Kentucky,Benton,416 High School Rd,2,14,16
480366,16-Sep-13,District of Columbia,Washington Navy Yard,1336 Isaac Hull Ave,13,3,16
2242153,26-Feb-22,Nevada,Las Vegas,953 E Sahara Ave,1,14,15
2032220,12-Jun-21,Texas,Austin,400 block of E 6th St,1,14,15
2012765,22-May-21,South Carolina,North Charleston,Piggly Wiggly Dr and W Jimtown Dr,1,14,15
1952281,14-Mar-21,Illinois,Chicago,6798 block of S South Chicago Ave,2,13,15
1741838,21-Jul-20,Illinois,Chicago,1018 W 79th St,0,15,15
1725690,5-Jul-20,Georgia,Atlanta,200 block of Auburn Ave,2,13,15
1249561,7-Nov-18,California,Thousand Oaks,99 Rolling Oaks Dr,13,2,15
676663,15-Oct-16,California,Los Angeles,2918 Rimpau Blvd,4,11,15
604233,16-Jul-16,California,Bakersfield,621 Stephens Dr,1,14,15
197384,28-Sep-14,Florida,Miami,NW 7th Ave and NW 64th St,0,15,15
2187990,12-Dec-21,Texas,Baytown,1403 N Market Loop,1,13,14
2155329,31-Oct-21,Illinois,Joliet,1018 E Jackson St,2,12,14
2012633,22-May-21,New Jersey,Bridgeton,1029 E Commerce St,3,11,14
597756,7-Jul-16,Texas,Dallas,800 Main St,5,9,14
2301751,14-May-22,New York,Buffalo,1275 Jefferson Ave,10,3,13
1739434,19-Jul-20,Illinois,Peoria,NE Water St and Hamilton Blvd,0,13,13
1681588,16-May-20,Louisiana,Bogalusa,Martin Luther King Dr and E 4th St,0,13,13
1577518,22-Dec-19,Illinois,Chicago,5700 block of S May St,0,13,13
634787,21-Aug-16,Connecticut,Bridgeport,19 Plymouth St,0,13,13
480765,5-Oct-13,California,Fresno,3883 E. Calwa #114,1,12,13
480521,19-Sep-13,Illinois,Chicago,1809 W 50th St,0,13,13
482771,11-Mar-13,District of Columbia,Washington,1200 North Capitol St NW,0,13,13
2291712,1-May-22,Louisiana,Lafayette,500 Jefferson St,0,12,12
2274790,10-Apr-22,Iowa,Cedar Rapids,415 3rd St SE,2,10,12
2053262,5-Jul-21,Ohio,Toledo,Lawrence Ave and Wall St,1,11,12
1565216,6-Dec-19,Florida,Pensacola,280 Taylor Rd,4,8,12
1561734,1-Dec-19,Louisiana,New Orleans,700 block of Canal St,0,12,12
1537672,29-Oct-19,California,Long Beach,2709 E 7th St,3,9,12
1459718,27-Jul-19,New York,Brooklyn,1555 Linden Blvd,1,11,12
1327321,15-Feb-19,Illinois,Aurora,641 Archer Ave,6,6,12
1196028,26-Aug-18,Florida,Jacksonville,2 Independent Dr,3,9,12
853901,28-May-17,Alabama,Phenix City,100 block of 6th Street South,0,12,12
501233,7-Feb-16,Florida,Orlando,7432 Universal Blvd,2,10,12
454059,27-Nov-15,Colorado,Colorado Springs,3480 Centennial Blvd,3,9,12
390774,8-Aug-15,Arkansas,Blytheville,833 Anderson Street,1,11,12
380162,23-Jul-15,Louisiana,Lafayette,3141 Johnson Street,3,9,12
361212,20-Jun-15,Michigan,Detroit,Dexter and Webb,1,11,12
2280711,17-Apr-22,Pennsylvania,Pittsburgh,900B Madison Ave,2,9,11
2231371,11-Feb-22,Arizona,Phoenix,5405 W Warner St,2,9,11
2178487,30-Nov-21,Michigan,Oxford,745 N Oxford Rd,4,7,11
2046897,27-Jun-21,Illinois,Chicago,6300 block of South Artesian Ave,1,10,11
2041363,20-Jun-21,Florida,Wildwood,9605 Co Rd 235,1,10,11
1958652,22-Mar-21,Colorado,Boulder,3600 Table Mesa Dr,10,1,11
1864683,29-Nov-20,Mississippi,Grenada,Highway 8 East,0,11,11
1863726,28-Nov-20,South Carolina,Aiken,1695 Richland Ave E,1,10,11
1765636,16-Aug-20,Ohio,Cincinnati,70 E McMicken Ave,2,9,11
1711410,21-Jun-20,Minnesota,Minneapolis,2939 Hennepin Ave S,0,11,11
1429047,23-Jun-19,Indiana,South Bend,1150 E Mishawaka Ave,1,10,11
743995,6-Jan-17,Florida,Fort Lauderdale,100 Terminal Dr,5,6,11
647865,4-Sep-16,Virginia,Roanoke,1020 Orange Ave NE,1,10,11
138282,23-May-14,California,Goleta,840 Embarcadero del Norte,4,7,11
2276339,12-Apr-22,New York,Brooklyn,36th St and 4th Ave,0,10,10
2258182,19-Mar-22,Texas,Dallas,5214 Botham Jean Blvd,1,9,10
2244673,26-Feb-22,Louisiana,Bogalusa,E 4th St and Martin Luther King Jr Dr,0,10,10
2155001,30-Oct-21,Texas,Texarkana,2315 Texas Blvd,1,9,10
2143479,17-Oct-21,Arkansas,Pine Bluff,820 S Main St,1,9,10
2079516,31-Jul-21,New York,Corona (Queens),97-07 37th Ave,0,10,10
2032203,12-Jun-21,Illinois,Chicago,7500 block of S Prairie Ave,1,9,10
2015730,26-May-21,California,San Jose,101 W Younger Ave,10,0,10
1834617,24-Oct-20,Mississippi,Greenwood,W Martin Luther King Dr,2,8,10
1725108,5-Jul-20,South Carolina,Greenville,1701 White Horse Rd,2,8,10
1551531,17-Nov-19,California,Fresno,5361 E Lamona Ave,4,6,10
1508804,21-Sep-19,South Carolina,Lancaster,1399 Old Charlotte Rd,2,8,10
1426537,20-Jun-19,Pennsylvania,Allentown,343 Hamilton St,0,10,10
1405196,25-May-19,Virginia,Chesapeake,Holly Cove Dr and Schooner Trail,1,9,10
1174190,28-Jul-18,Louisiana,New Orleans,3400 S Claiborne Ave,3,7,10
930569,10-Sep-17,Texas,Plano,1712 West Spring Creek Parkway,9,1,10
848292,20-May-17,Pennsylvania,Philadelphia,2100 block of W Huntingdon St,0,10,10
838272,7-May-17,Illinois,Chicago,2600 block of 46th Pl,2,8,10
761973,27-Jan-17,Tennessee,Brownsville,221 Morgan St,0,10,10
711597,27-Nov-16,Louisiana,New Orleans,100 block of Bourbon Street,1,9,10
421014,27-Sep-15,Georgia,Greenville,1140 Hill Haven Road,0,10,10
361198,20-Jun-15,Pennsylvania,Philadelphia,4100 block of Ogden St,0,10,10
152468,29-Jun-14,Louisiana,New Orleans,700 block of Bourbon St,1,9,10
493035,7-Nov-13,Michigan,Detroit,Conley and 7 Mile,3,7,10
2308017,20-May-22,California,Highland,3606 Highland Ave,1,8,9
2307044,19-May-22,Illinois,Chicago,800 block of N State St,2,7,9
2280875,17-Apr-22,South Carolina,Furman,72 Ashley Circle Rd,0,9,9
2280204,16-Apr-22,South Carolina,Columbia,100 Columbiana Cir,0,9,9
2080733,2-Aug-21,South Carolina,Columbia,6908 Two Notch Rd,0,9,9
2053508,4-Jul-21,Nevada,North Las Vegas,1200 block of W Helen Ave,2,7,9
2026123,6-Jun-21,Florida,Miami (Kendall),10549 SW 109th Ct,3,6,9
2026257,5-Jun-21,Louisiana,New Orleans,10150 I-10 Service Rd,0,9,9
2011569,22-May-21,Minnesota,Minneapolis,322 N 1st Ave,2,7,9
1980971,17-Apr-21,Louisiana,La Place (Laplace),624 Golfview Dr,0,9,9
1962562,26-Mar-21,Virginia,Virginia Beach,2000 block of Atlantic Ave,0,9,9
1954379,16-Mar-21,Georgia,Acworth,6468 Hwy 92,8,1,9
1793521,13-Sep-20,New Jersey,New Brunswick,32 Delafield St,2,7,9
1759873,9-Aug-20,Colorado,Denver,1400 block of W Byers Pl,0,9,9
1739658,19-Jul-20,District of Columbia,Washington,3600 block of 14th St NW,1,8,9
1712342,22-Jun-20,North Carolina,Charlotte,1800 block of Beatties Ford Rd,4,5,9
1711285,20-Jun-20,New York,Syracuse,Marcellus St and Wyoming St,1,8,9
1699211,7-Jun-20,Missouri,Sikeston,915 Plantation Blvd,2,7,9
1581103,27-Dec-19,Texas,Houston,500 block of Smart St,2,7,9
1568230,10-Dec-19,New Jersey,Jersey City,223 Martin Luther King Dr,6,3,9
1520330,6-Oct-19,Kansas,Kansas City,1013 Central Ave,4,5,9
1404417,25-May-19,New Jersey,Trenton,225 Brunswick Ave,0,9,9
1398553,18-May-19,Alabama,Atmore,100 Martin Luther King Avenue,1,8,9
1389220,7-May-19,Colorado,Littleton (Highlands Ranch),8773 S Ridgeline Blvd,1,8,9
966178,22-Oct-17,Alabama,Lanett,1606 19th St Sw,2,7,9
940554,24-Sep-17,Tennessee,Antioch,3890 Pin Hook Rd,1,8,9
886220,8-Jul-17,Ohio,Cincinnati,9917 Capstan Dr,1,8,9
864743,11-Jun-17,Illinois,Chicago,3300 block of W Douglas Blvd,0,9,9
853756,27-May-17,Mississippi,Bogue Chitto,2871 Lee Dr,8,1,9
821371,16-Apr-17,Ohio,Columbus,1710 Cleveland Av,0,9,9
672203,9-Oct-16,Michigan,Grand Rapids,1850 28th Street SE,1,8,9
657634,17-Sep-16,District of Columbia,Washington,2600 block of Birney Pl SE,2,7,9
517073,6-Mar-16,California,Compton,900 block of West Victoria Street,1,8,9
385779,2-Aug-15,New York,Brooklyn,Stanley Avenue and Crescent Street,0,9,9
368732,5-Jul-15,Indiana,Fort Wayne,1400 block of McCulloch Street,0,9,9
359830,17-Jun-15,South Carolina,Charleston,110 Calhoun Street,9,0,9
356065,11-Jun-15,Connecticut,Bridgeport,468 Trumbull Ave,1,8,9
298122,26-Feb-15,Missouri,Tyrone,18279 Highway H,8,1,9
266424,21-Dec-14,Illinois,Calumet City,600 block of Escanba,1,8,9
171802,9-Aug-14,Minnesota,Minneapolis,400 3rd Ave N,1,8,9
150299,24-Jun-14,Florida,Miami,Northwest 12th Avenue and 65th Street,2,7,9
490226,30-Jun-13,New York,Brooklyn,616 E. 52nd Street,0,9,9
489105,23-Jun-13,Missouri,Kansas City,1917 Prospect Ave,1,8,9
2227058,5-Feb-22,Texas,Corsicana,2919 W 2nd Ave,6,2,8
2198521,27-Dec-21,Colorado,Denver,56 Broadway,6,2,8
2148633,23-Oct-21,Georgia,Fort Valley,603 Carver Dr,1,7,8
2143277,17-Oct-21,Louisiana,Grambling,403 Main St,1,7,8
2119950,19-Sep-21,South Carolina,Yemassee,145 Yemassee Hwy,1,7,8
2092469,16-Aug-21,New York,Brooklyn,927 DeKalb Ave,0,8,8
2070645,21-Jul-21,Illinois,Chicago,1647 N La Salle Dr,0,8,8
2052353,4-Jul-21,Texas,Fort Worth,3400 block of Horne St,0,8,8
2041297,20-Jun-21,California,Richmond,2108 Dunn Ave,3,5,8
2040374,20-Jun-21,Texas,Dallas,4619 E. R L Thornton Freeway,0,8,8
2039964,19-Jun-21,California,Oakland,2200 block of Lakeshore Ave,1,7,8
2035452,15-Jun-21,Illinois,Chicago,6221 S Morgan St,5,3,8
2031976,11-Jun-21,Georgia,Savannah,200 block of Avery St,2,6,8
2027725,6-Jun-21,Ohio,Cleveland,3700 block of Woodbridge Ave,0,8,8
2026112,6-Jun-21,Illinois,Chicago,8900 block of S Cottage Grove Ave,0,8,8
2003334,13-May-21,Rhode Island,Providence,87 Carolina Ave,0,8,8
1999193,9-May-21,Arizona,Phoenix,122 N 2nd St,1,7,8
1961753,26-Mar-21,Illinois,Chicago,2515 W 79th St,1,7,8
1957226,20-Mar-21,Texas,Dallas,10333 Technology Blvd,1,7,8
1931288,17-Feb-21,Pennsylvania,Philadelphia,5597 Old York Rd,0,8,8
1898261,9-Jan-21,Illinois,Evanston,100 Asbury Ave,6,2,8
1893744,3-Jan-21,Florida,Miami,10525 NW 24th Ave,0,8,8
1857040,20-Nov-20,Wisconsin,Milwaukee (Wauwatosa),2500 N Mayfair Rd,0,8,8
1849308,10-Nov-20,Florida,Tampa,N 50th St and Sligh Ave,1,7,8
1846494,8-Nov-20,Tennessee,Nashville,2nd Ave N and Commerce St,0,8,8
1823101,10-Oct-20,South Carolina,Kingstree,55 Williamsburg County Hwy,0,8,8
1806002,26-Sep-20,Iowa,Waterloo,501 W 4th St,2,6,8
1739571,19-Jul-20,Nebraska,Omaha,28th St and T Ave,0,8,8
1735470,14-Jul-20,North Carolina,Durham,200 Block of S Benjamine St,0,8,8
1732485,12-Jul-20,Louisiana,Baton Rouge,4718 Plank Rd,1,7,8
1725081,4-Jul-20,Illinois,Chicago,6100 block of S Carpenter St,4,4,8
1704415,13-Jun-20,New York,Wyandanch,76 Grand Blvd,1,7,8
1703985,12-Jun-20,Texas,San Antonio,8134 Broadway St,0,8,8
1688753,26-May-20,South Carolina,Bowman,Dibble St and Rail St,3,5,8
1603241,22-Jan-20,Washington,Seattle,1530 3rd Ave,1,7,8
1577688,22-Dec-19,Minnesota,Minneapolis (Spring Lake Park),8407 Plaza Blvd NE,1,7,8
1539347,31-Oct-19,California,Orinda,114 Lucille Way,5,3,8
1535478,26-Oct-19,Texas,Greenville,2275 US-380,2,6,8
1468190,4-Aug-19,Illinois,Chicago,1800 S Kildare Ave,1,7,8
1381979,28-Apr-19,Maryland,Baltimore,2544 Edmondson Ave,1,7,8
1223865,3-Oct-18,South Carolina,Florence,932 Ashton Dr,2,6,8
1202332,2-Sep-18,California,San Bernardino,1277 East Lynwood Drive,0,8,8
1201135,1-Sep-18,Ohio,Cleveland,3232 Lakeside Ave East,1,7,8
1179607,5-Aug-18,Illinois,Chicago,1300 block of W 76th St,0,8,8
1121111,20-May-18,Mississippi,Hazlehurst,513 Monticello St,1,7,8
1052035,17-Feb-18,Kansas,Kansas City,1615 Minnesota,1,7,8
1017372,31-Dec-17,Colorado,Littleton (Highlands Ranch),3404 E County Line Rd,2,6,8
934036,16-Sep-17,South Carolina,Columbia,920 Lady Street,0,8,8
879412,30-Jun-17,New York,Bronx,1650 Grand Concourse,2,6,8
853119,27-May-17,District of Columbia,Washington,100 block of Q St NW,1,7,8
832679,30-Apr-17,California,San Diego,9080 Judicial Dr,2,6,8
752222,16-Jan-17,Florida,Miami,6011 NW 32nd Ave,0,8,8
703245,17-Nov-16,Tennessee,Dyersburg,160 Longfellow,1,7,8
693374,5-Nov-16,California,Oakland,420 14th Street,0,8,8
662342,24-Sep-16,Maryland,Baltimore,Greenmount Ave and Preston St,0,8,8
610584,24-Jul-16,Ohio,Hamilton,1555 Main St,1,7,8
595482,4-Jul-16,Arizona,Phoenix,4000 block of West Southern Avenue,2,6,8
567614,29-May-16,Texas,Houston,13210 Memorial Dr,2,6,8
553803,5-May-16,Louisiana,Shreveport,300 block of North Thomas Drive,2,6,8
553570,4-May-16,Minnesota,Minneapolis,16th Avenue North and Newton Avenue North,1,7,8
545525,22-Apr-16,Ohio,Piketon,4077 Union Hill Rd,8,0,8
519541,9-Mar-16,Pennsylvania,Pittsburgh (Wilkinsburg),1304 Franklin Ave,6,2,8
508640,20-Feb-16,Michigan,Kalamazoo,5581 Cracker Barrel Blvd,6,2,8
501168,7-Feb-16,New York,Rochester,547 State St,1,7,8
500556,6-Feb-16,Florida,Tampa,8123 N Nebraska Ave,2,6,8
495940,30-Jan-16,Arizona,Glendale,67th and Missouri Avenue,3,5,8
400091,23-Aug-15,California,Modesto,1100 block of Kansas Avenue,1,7,8
399212,21-Aug-15,North Carolina,Durham,2700 block of Hinson Drive,0,8,8
390526,8-Aug-15,Texas,Houston,2211 Falling Oaks,8,0,8
375022,16-Jul-15,Tennessee,Chattanooga,4051 Amnicola Hwy,6,2,8
283041,24-Jan-15,Nebraska,Omaha,3402 Parker St,3,5,8
198051,29-Sep-14,South Carolina,Walterboro,29 Sandy Dam Lane,1,7,8
192851,18-Sep-14,Florida,Bell,2550 NW 29th Terrace,8,0,8
189562,11-Sep-14,Michigan,Detroit,14000 block of Patton,1,7,8
163930,26-Jul-14,Georgia,Sylvester,Royal Street,0,8,8
140185,23-May-14,Louisiana,New Orleans,6200 block of Eads Street,1,7,8
131998,3-May-14,Arkansas,Jonesboro,2201 Moore Rd,4,4,8
107519,16-Feb-14,Texas,Dallas,2600 block of South Harwood Street,1,7,8
496668,28-Dec-13,Alabama,Montgomery,954 Highland Ave,3,5,8
496634,26-Dec-13,Louisiana,Slidell,2144 First St,2,6,8
481043,13-Oct-13,Pennsylvania,Harrisburg,1524 Walnut St,0,8,8
491698,7-Aug-13,Texas,Dallas,7100 block of Long Canyon Trail,4,4,8
480443,24-Feb-13,Georgia,Macon,2800 block of Mercer University Drive,0,8,8
478978,12-Jan-12,Louisiana,New Orleans,7400 block of Devine Avenue,4,4,8
2303130,15-May-22,North Carolina,Winston Salem (Winston-salem),2000 block of 25th St,0,7,7
2281410,16-Apr-22,Texas,Daingerfield,FM 144 and Edwards Rd,1,6,7
2275283,10-Apr-22,California,Willowbrook,Blakley Ave and E 122nd Pl,2,5,7
2252873,13-Mar-22,Illinois,Chicago,7902 S Exchange Ave,0,7,7
2246387,3-Mar-22,Nevada,Las Vegas,4055 S University Center Dr,1,6,7
2237697,19-Feb-22,Oregon,Portland,NE 55th Ave and NE Hassalo St,1,6,7
2237196,19-Feb-22,California,Turlock,142 S 1st St,0,7,7
2207469,9-Jan-22,Alabama,Montgomery,3020 Atlanta Hwy,1,6,7
2201716,31-Dec-21,Mississippi,Gulfport,1200 block of Lewis Ave,4,3,7
2200968,30-Dec-21,Pennsylvania,Philadelphia,5100 block of Germantown Ave,0,7,7
2197421,26-Dec-21,Mississippi,Fayette,225 Community Dr,1,6,7
2176922,28-Nov-21,Maryland,Baltimore,1300 block of North Montford Ave,0,7,7
2176058,26-Nov-21,Tennessee,Nashville,2815 Torbett St,3,4,7
2154873,30-Oct-21,California,Sacramento,5560 Palm Ave,2,5,7
2148401,22-Oct-21,Maryland,Baltimore,3100 block of W North Ave,0,7,7
2143765,17-Oct-21,Texas,Houston,1900 block of Dolly Wright St,0,7,7
2137575,9-Oct-21,New York,Albany,100 block of North Lake Ave,1,6,7
2126241,25-Sep-21,Tennessee,Chattanooga,1124 Grove St,2,5,7
2111858,9-Sep-21,Illinois,East Saint Louis,510 Martin Luther King Dr,0,7,7
2100578,26-Aug-21,Minnesota,Minneapolis,3006 Lyndale Ave,0,7,7
2089972,13-Aug-21,Nevada,Las Vegas,2601 E Sunset Rd,1,6,7
2085388,8-Aug-21,Illinois,Chicago,1800 block of W 87th St,1,6,7
2066905,18-Jul-21,Arizona,Tucson,1575 E 36th St,4,3,7
2065252,17-Jul-21,Oregon,Portland,300 block of SW 3rd Ave,1,6,7
2060949,13-Jul-21,Michigan,Detroit,9855 Chalmers St,1,6,7
2050593,1-Jul-21,Illinois,Chicago,6500 block of S Halsted St,0,7,7
2041726,21-Jun-21,Missouri,Saint Louis,4002 Sullivan Ave,3,4,7
2033905,13-Jun-21,Ohio,West Salem,9161 Rainbow Hwy,1,6,7
2032486,12-Jun-21,Ohio,Cleveland,8805 Buckeye Rd,3,4,7
2018931,28-May-21,Florida,Miami,2022 NW 1st Ct,1,6,7
2007722,18-May-21,California,Oakland,I-580 and Seminary Ave,2,5,7
2001362,10-May-21,Alabama,Montgomery,3804 S Court St,0,7,7
1999125,9-May-21,Colorado,Colorado Springs,2828 Preakness Way,7,0,7
1988326,26-Apr-21,Oregon,Gresham,SE Stark St and SE 174th Ave,0,7,7
1971410,7-Apr-21,South Carolina,Rock Hill,4456 Marshall Rd,7,0,7
1970378,5-Apr-21,Illinois,Chicago,6800 block of S Justine Ave,0,7,7
1967914,3-Apr-21,North Carolina,Wilmington,718 Kidder St,3,4,7
1968553,3-Apr-21,Florida,Quincy,2114 Pat Thomas Parkway,0,7,7
1963556,28-Mar-21,Ohio,Cleveland,5100 Pearl Rd,0,7,7
1962507,26-Mar-21,Pennsylvania,Philadelphia,1080 N Delaware Ave,0,7,7
1917909,2-Feb-21,Oklahoma,Muskogee,903 Indiana St,6,1,7
1904036,17-Jan-21,Arizona,Phoenix,2236 E University Dr,1,6,7
1894941,4-Jan-21,Florida,Fort Lauderdale (Lauderhill),1828 NW 38th Ave,0,7,7
1892034,1-Jan-21,Arkansas,Fort Smith,3211 Towson Ave,0,7,7
1859390,22-Nov-20,New York,Brooklyn,15 Albany Ave,1,6,7
1840041,31-Oct-20,Maryland,College Park,7700 Baltimore Ave,0,7,7
1826655,16-Oct-20,Arizona,Mesa,2115 Guadalupe Rd,1,6,7
1825896,15-Oct-20,Maryland,Baltimore,2900 block of Westwood Ave,0,7,7
1818055,8-Oct-20,Pennsylvania,Philadelphia,4935 Frankford Ave,1,6,7
1813872,4-Oct-20,Indiana,Indianapolis,5462 Massachusetts Ave,3,4,7
1810358,30-Sep-20,Wisconsin,Milwaukee,4217 W Fond du Lac Ave,0,7,7
1793826,13-Sep-20,Michigan,Grand Rapids,3950 Stahl Dr SE,0,7,7
1788352,7-Sep-20,California,Aguanga,45125 Highway 371,7,0,7
1786855,6-Sep-20,Georgia,Sparta,Faye St and Lee St,1,6,7
1780301,30-Aug-20,Kentucky,Lexington,545 N Upper St,0,7,7
1772623,23-Aug-20,Arkansas,Pine Bluff,2901 W 28th Ave,0,7,7
1745737,25-Jul-20,California,Manteca,4447 Woodward Ave,0,7,7
1728683,7-Jul-20,New Jersey,Paterson,Harrison St and Carroll St,4,3,7
1719668,28-Jun-20,Alabama,Akron,Co Rd 21,0,7,7
1718847,27-Jun-20,California,Red Bluff,10815 State Hwy 99W,3,4,7
1708889,18-Jun-20,New York,Albany,8 Albany St,0,7,7
1704879,14-Jun-20,Minnesota,Minneapolis,328 W Broadway Ave,1,6,7
1704580,13-Jun-20,Georgia,Atlanta,69 Mason Ave NE,2,5,7
1704727,13-Jun-20,District of Columbia,Washington,3100 block of Waclark Pl SE,2,5,7
1702172,11-Jun-20,District of Columbia,Washington,1200 block of Mt Olivet Rd NE,0,7,7
1701426,9-Jun-20,Pennsylvania,Philadelphia,600 block of N 8th St,1,6,7
1697453,4-Jun-20,Alabama,Valhermoso Springs,522 Talucah Rd,7,0,7
1691221,28-May-20,Kentucky,Louisville,601 W Jefferson St,0,7,7
1687027,23-May-20,South Carolina,Jonesville,100 block of Dover Rd,2,5,7
1665834,25-Apr-20,Tennessee,Memphis,500 block of Josephine St,0,7,7
1641216,17-Mar-20,Maryland,Baltimore,300 block of McMechen St,0,7,7
1640295,15-Mar-20,North Carolina,Moncure,842 Moncure Flatwood Rd,7,0,7
1640317,15-Mar-20,Missouri,Springfield,3264 E Battlefield Rd,5,2,7
1635411,7-Mar-20,Illinois,Chicago,900 block of E 79th St,0,7,7
1627713,23-Feb-20,Texas,Houston,8712 Airline Dr,0,7,7
1622233,15-Feb-20,Tennessee,Memphis,2800 block of Riverport Rd,0,7,7
1600522,19-Jan-20,Texas,San Antonio,1011 Avenue B,2,5,7
1585394,1-Jan-20,West Virginia,Huntington,1113 4th Ave,0,7,7
1577577,22-Dec-19,Maryland,Baltimore,225 Park Ave,0,7,7
1577046,20-Dec-19,Mississippi,Waynesboro,Turner St,1,6,7
1560645,29-Nov-19,Texas,Amarillo,2650 Dumas Dr,0,7,7
1556002,23-Nov-19,Louisiana,Tallulah,Depot St,1,6,7
1525062,12-Oct-19,New York,Brooklyn,75 Utica Ave,4,3,7
1494548,1-Sep-19,Alabama,Valley,502 Boulevard,0,7,7
1487729,25-Aug-19,New Mexico,Hobbs,1700 block of E Bond St,3,4,7
1487356,24-Aug-19,Maryland,Temple Hills (Camp Springs),6200 block of Maxwell Dr,0,7,7
1468091,4-Aug-19,Illinois,Chicago,2900 block of W Roosevelt Rd,0,7,7
1461352,28-Jul-19,Wisconsin,Chippewa Falls,16964 54th Ave,5,2,7
1452617,20-Jul-19,Illinois,Chicago,2401 N Lake Shore Dr,0,7,7
1447057,13-Jul-19,Pennsylvania,Philadelphia,5433 Lansdowne Ave,0,7,7
1435028,29-Jun-19,Louisiana,Baton Rouge,7132 Florida Blvd,0,7,7
1434971,28-Jun-19,Georgia,Atlanta,Ira St and Bass St SW,0,7,7
1432989,27-Jun-19,Georgia,Atlanta,600 block of Parkway Dr,0,7,7
1423330,16-Jun-19,Kentucky,Louisville,Dixie Highway and Ormsby Ave,1,6,7
1418180,8-Jun-19,Washington,White Swan,5151 Medicine Valley Rd,5,2,7
1398538,18-May-19,Indiana,Muncie,2410 W. Euclid Ave,1,6,7
1381857,28-Apr-19,Tennessee,Nashville,1407 Dr DB Todd Jr Blvd,0,7,7
1365052,7-Apr-19,North Carolina,Winston Salem (Winston-salem),515 N Cherry St,0,7,7
1359599,31-Mar-19,South Carolina,North Charleston,1900 block of Jacksonville Rd,0,7,7
1354049,24-Mar-19,Arizona,Phoenix,2202 W McDowell Rd,0,7,7
1318391,3-Feb-19,Illinois,Chicago,938 E 75th St,2,5,7
1314289,28-Jan-19,Texas,Houston,7815 Harding St,2,5,7
1293054,4-Jan-19,California,Torrance,22501 Hawthorne Blvd,3,4,7
1283229,23-Dec-18,Missouri,Springfield,1042 W College St,1,6,7
1262013,23-Nov-18,Florida,Miami,5801 NW 27th Ave,2,5,7
1246489,2-Nov-18,Florida,Tallahassee,1950 Thomasville Rd,3,4,7
1243331,29-Oct-18,California,Riverside,3252 Mission Inn Ave,0,7,7
1213926,20-Sep-18,Maryland,Aberdeen,1501 Perryman Rd,4,3,7
1202318,2-Sep-18,Alabama,Birmingham,500 23rd St S,0,7,7
1189717,17-Aug-18,Illinois,Chicago,1600 block of W 65th St,0,7,7
1172224,26-Jul-18,Ohio,Cleveland,18416 St Clair Ave,1,6,7
1169103,21-Jul-18,Illinois,Chicago,3100 block of W Fulton St,2,5,7
1153134,30-Jun-18,Georgia,Ashburn,800 Block of W. Washington,1,6,7
1148468,24-Jun-18,North Carolina,Sanford,109 S Steele St,1,6,7
1137547,10-Jun-18,Illinois,Aurora,300 block of W Park Ave,0,7,7
1131855,2-Jun-18,Nebraska,Omaha,S 11th St and Farnam St,1,6,7
1096826,22-Apr-18,Tennessee,Antioch,3571 Murfreesboro Pike,4,3,7
1095043,18-Apr-18,North Carolina,Asheville,73 Hansel Ave,4,3,7
1071427,17-Mar-18,Kentucky,Louisville,2928 W Kentucky St,0,7,7
1047761,11-Feb-18,Michigan,Detroit,19432 Lamont St,4,3,7
994323,24-Nov-17,Mississippi,Brookhaven,119 Martin Street,1,6,7
989838,16-Nov-17,Georgia,Columbus,1400 block of 15th Street,0,7,7
986236,12-Nov-17,Indiana,Gary,4601 Melton Rd,0,7,7
916848,20-Aug-17,Illinois,Chicago,11901 S Loomis St,2,5,7
909423,8-Aug-17,Illinois,Chicago,50 block of E 37th St,1,6,7
907857,6-Aug-17,California,Oakland,1000 block of 106th Avenue,0,7,7
904026,1-Aug-17,California,Fresno,Mariposa St and A St,0,7,7
898631,26-Jul-17,North Carolina,High Point,2111 E. Green Drive,1,6,7
886564,9-Jul-17,Virginia,Lawrenceville,500 block of Sturgeon Rd,0,7,7
873847,22-Jun-17,Georgia,Atlanta,1100 block of Osborne Street,1,6,7
869968,18-Jun-17,South Carolina,Myrtle Beach,311 N Ocean Blvd,0,7,7
864370,9-Jun-17,Texas,Fort Worth,East Davis Avenue and New York Avenue,2,5,7
843078,14-May-17,Arkansas,Jonesboro,311 S Main St,1,6,7
811089,3-Apr-17,Texas,Lubbock,5401 Ave Q,0,7,7
802240,24-Mar-17,Missouri,Saint Louis,5100 block of Palm St,1,6,7
773002,12-Feb-17,Missouri,Caruthersville,908 Truman Blvd,1,6,7
739766,1-Jan-17,Florida,Miami,8000 block of NW 14th Ave,0,7,7
734157,25-Dec-16,Illinois,Chicago,8600 block of S Maryland Ave,3,4,7
732927,24-Dec-16,North Carolina,Madison,490 K Ford Rd,0,7,7
711744,27-Nov-16,Missouri,Kansas City,Gregory and Prospect,0,7,7
688577,30-Oct-16,New York,Newburgh,119 First Street,2,5,7
682298,22-Oct-16,California,Oakland,77th and Bancroft Avenues,0,7,7
676376,14-Oct-16,Illinois,Chicago,3300 block of W Maypole Ave,1,6,7
663106,26-Sep-16,Texas,Houston,5450 Weslayan St,1,6,7
657136,17-Sep-16,Florida,Orlando,3918 Columbia St,1,6,7
657023,16-Sep-16,Pennsylvania,Philadelphia,5100 block of Sansom St,2,5,7
640500,27-Aug-16,Alabama,Bessemer (Brighton),3810 7th Ave,1,6,7
624273,8-Aug-16,Florida,Jacksonville,1214 Labelle St,0,7,7
617334,29-Jul-16,Georgia,Athens,Trail Creek St,0,7,7
604762,17-Jul-16,Louisiana,Baton Rouge,9611 Airline Hwy,5,2,7
595166,4-Jul-16,New York,Brooklyn,419 Chauncey St,0,7,7
587755,25-Jun-16,Texas,Fort Worth,2466 East Lancaster Avenue,2,5,7
543108,17-Apr-16,Texas,Edinburg,5021 W St Hwy 107,1,6,7
517058,6-Mar-16,Massachusetts,Chelsea,120 Washington Avenue,1,6,7
399367,21-Aug-15,Ohio,Cincinnati,Mathis and Prentice,2,5,7
398361,19-Aug-15,New York,Rochester,500 Genesee St,3,4,7
386140,2-Aug-15,Maryland,Baltimore,2700 block of Garrison Avenue,0,7,7
382413,24-Jul-15,Pennsylvania,Erie,200 block of W 29th St,2,5,7
375412,15-Jul-15,Ohio,Cleveland,700 block of Thornhill,0,7,7
361948,22-Jun-15,Pennsylvania,Philadelphia,700 block of East Hilton Street,0,7,7
345749,24-May-15,Michigan,Flint,W. 12th Street and Hammerberg Road.,0,7,7
333576,3-May-15,Ohio,Dayton,2801 Germantown Street,1,6,7
329322,25-Apr-15,New York,Gates,24 Hinchey Rd,1,6,7
314044,27-Mar-15,Florida,Panama City Beach,5312 Thomas Drive,0,7,7
311348,22-Mar-15,New Mexico,Albuquerque,10140 Lomas NE,1,6,7
308687,17-Mar-15,California,Stockton,748 N Madison St,3,4,7
300860,4-Mar-15,California,San Bernardino,190 block of W Club Center Dr,3,4,7
289811,7-Feb-15,Georgia,Douglasville,3640 Willow Tree Circle,5,2,7
281039,19-Jan-15,Texas,San Antonio,1000 block of Gibbs St.,2,5,7
276845,11-Jan-15,North Carolina,Hope Mills,1900 block of Gumberry Road,2,5,7
263556,15-Dec-14,Pennsylvania,Lansdale,100 block of West 5th St,7,0,7
180007,24-Aug-14,California,San Fernando,1400 block of Celis Street ,3,4,7
172304,10-Aug-14,Louisiana,New Orleans,5400 block of Burgundy St,2,5,7
172180,10-Aug-14,California,Moreno Valley,16300 block of Heather Glen Road ,0,7,7
168551,3-Aug-14,Texas,Humble,3403 FM 1960,0,7,7
168169,2-Aug-14,Massachusetts,New Bedford,Acushnet Avenue,0,7,7
176329,30-Jul-14,North Carolina,Hope Mills,5109 New Moon Dr,3,4,7
163874,25-Jul-14,Illinois,Chicago,700 S California Ave,1,6,7
156670,9-Jul-14,Texas,Spring,711 Leaflet Ln,6,1,7
154721,5-Jul-14,Indiana,Indianapolis,Broad Ripple Avenue,0,7,7
154834,5-Jul-14,Virginia,Norfolk,861 W. 36th Street,0,7,7
152960,28-Jun-14,California,Antioch,5500 Cedar Point Way,0,7,7
142076,2-Jun-14,Illinois,Chicago,2660 E. 79th St,0,7,7
135904,18-May-14,Ohio,Sandusky,1643 Cleveland Rd,0,7,7
134238,11-May-14,Tennessee,Memphis,2517 Shasta,0,7,7
156823,10-May-14,California,Sacramento,3031 Guadalajara Way,1,6,7
130232,29-Apr-14,Georgia,Kennesaw,1675 Airport Road,1,6,7
117914,23-Mar-14,California,San Francisco,Turk and Taylor,0,7,7
107417,16-Feb-14,Florida,Orlando (Pine Hills),4500 block of Charlene Terrace,1,6,7
495145,25-Nov-13,California,Oakland,96th Avenue and Olive Street,0,7,7
492570,27-Oct-13,California,Vallejo,200 block of Princeton Avenue,1,6,7
481268,21-Oct-13,Pennsylvania,Pittsburgh (Homewood),7200 block of Kelly Street,2,5,7
480646,22-Sep-13,Kansas,Wichita,100 block of N. Mead,1,6,7
491609,6-Aug-13,Pennsylvania,Saylorsburg,1000 Ross Municipal Dr,3,4,7
491473,4-Aug-13,California,Salinas,624 Williams Road,3,4,7
491265,26-Jul-13,Florida,Hialeah,1485 W 46th St,7,0,7
490351,4-Jul-13,Michigan,Pontiac,441 N Perry St,1,6,7
489581,7-Jun-13,California,Santa Monica,2036 Yorkshire Ave,6,1,7
487435,2-Jun-13,Georgia,Lagrange,Union Street,0,7,7
487271,2-Jun-13,Virginia,Virginia Beach,4000 block of Roebling Lane,0,7,7
485811,24-Apr-13,Illinois,Manchester,East Street,6,1,7
483737,21-Mar-13,Illinois,Chicago,West 87th Street and Ashland Avenue,0,7,7
482926,16-Mar-13,California,Galt,Dover Drive,0,7,7
482856,13-Mar-13,New York,Mohawk,17 W Main St,5,2,7
480358,19-Feb-13,California,Orange,Katella Avenue,4,3,7
492151,23-Jan-13,Maryland,Baltimore,1500 block of W. Fayette St.,1,6,7
2302847,15-May-22,California,Laguna Woods,24301 El Toro Rd,1,5,6
2299407,10-May-22,Illinois,Chicago,6400 block of S Richards Dr,0,6,6
2297261,8-May-22,Georgia,Clarkston,6500 block of Old Hampton Dr,3,3,6
2296037,6-May-22,Louisiana,New Orleans,4800 block of Alcee Fortier Blvd,2,4,6
2292452,1-May-22,Florida,Tarpon Springs,Safford Ave and Boyer St,0,6,6
2291470,30-Apr-22,Mississippi,Jackson,1207 Mississippi Street,1,5,6
2290903,29-Apr-22,Louisiana,New Orleans,3201 Magazine St,0,6,6
2286061,24-Apr-22,Indiana,Lafayette,2905 Westchester Ln W,2,4,6
2285158,22-Apr-22,Virginia,Petersburg,200 block of Holly Hill Dr,1,5,6
2274803,10-Apr-22,Illinois,Elgin,958 Congdon Ave,2,4,6
2274783,10-Apr-22,Indiana,Indianapolis,4270 W 38th St,1,5,6
2268762,2-Apr-22,Louisiana,Monroe,100 Sterlington Rd,1,5,6
2258012,19-Mar-22,North Carolina,Fayetteville,1707 Owen Dr,3,3,6
2232854,13-Feb-22,Wisconsin,Racine,7th St and Park Ave,1,5,6
2218159,23-Jan-22,Wisconsin,Milwaukee,2505 N 21st St,6,0,6
2212018,15-Jan-22,Georgia,Brunswick,2717 Glynn Ave,1,5,6
2211746,14-Jan-22,Oregon,Eugene,219 W 8th Ave,0,6,6
2207931,9-Jan-22,California,Los Angeles,W 35th St and S Hill St,2,4,6
2201216,31-Dec-21,California,Los Angeles,10211 S. Avalon Blvd,0,6,6
2196267,24-Dec-21,Pennsylvania,Pittsburgh,7300 block of Schoyer St,0,6,6
2188260,13-Dec-21,North Carolina,Durham,Eugene St and Mathison St,2,4,6
2187939,12-Dec-21,Mississippi,Bolton,6171 W. Northside Dr,0,6,6
2186246,9-Dec-21,Wisconsin,Beloit,1900 block of Porter Ave,1,5,6
2181096,2-Dec-21,North Carolina,Elizabeth City,Perry St and Jordan St,3,3,6
2179099,30-Nov-21,Georgia,Rex,3600 block of Jervis Court,4,2,6
2167297,15-Nov-21,Colorado,Aurora,1200 Nome St,0,6,6
2166673,14-Nov-21,Pennsylvania,Philadelphia,2700 block of N Howard St,0,6,6
2166768,14-Nov-21,Missouri,Columbia,19 N 5th St,1,5,6
2166817,14-Nov-21,Alabama,Troy,803 US-231 S,1,5,6
2160608,6-Nov-21,Texas,Marshall,510 S Alamo Blvd,0,6,6
2150274,25-Oct-21,Idaho,Boise,350 N Milwaukee St,3,3,6
2148921,23-Oct-21,South Carolina,Florence,811 S Irby St,0,6,6
2144160,17-Oct-21,Wisconsin,Racine,Yout St and Carter St,0,6,6
2143605,17-Oct-21,Mississippi,Jackson,3243 Medgar Evers Blvd,3,3,6
2155043,14-Oct-21,Mississippi,Mccomb,1300 14th St,0,6,6
2139048,12-Oct-21,Florida,Naples,700 block of 99th Ave,1,5,6
2139198,11-Oct-21,Georgia,South Fulton,4900 Delano Rd,0,6,6
2136907,9-Oct-21,Louisiana,Livingston,17000 block of LA-444,2,4,6
2134217,6-Oct-21,Maryland,Baltimore,1243 Patterson Park Ave,1,5,6
2130370,1-Oct-21,District of Columbia,Washington,Forrester St SW and Galveston Pl SW,1,5,6
2130763,1-Oct-21,Iowa,Cedar Rapids,525 33rd Ave SW,0,6,6
2125790,26-Sep-21,Illinois,Chicago,800 block of S Albany Ave,0,6,6
2126261,26-Sep-21,Washington,Seattle (Des Moines),22855 Pacific Hwy S,3,3,6
2125227,25-Sep-21,California,Riverside,6000 Block of Mariposa Ave,0,6,6
2120940,20-Sep-21,Pennsylvania,Philadelphia,Broad St and Chew Ave,1,5,6
2119745,19-Sep-21,Texas,Dallas,100 block of N Malcolm X Blvd,2,4,6
2116205,14-Sep-21,Ohio,Cleveland,2747 Cedar Ave,0,6,6
2114481,12-Sep-21,Michigan,Detroit,2700 block of Halleck St,2,4,6
2113841,11-Sep-21,Illinois,Chicago,300 block of E Kensington Ave,1,5,6
2110077,7-Sep-21,Kansas,Wichita,351 N Mosley St,1,5,6
2108378,5-Sep-21,Georgia,Athens,E Clayton St and N Jackson St,0,6,6
2108302,5-Sep-21,Florida,Lakeland,N Socrum Loop Rd and Fulton Green Rd,4,2,6
2107930,4-Sep-21,District of Columbia,Washington,700 block of Longfellow St NW,3,3,6
2104181,30-Aug-21,Illinois,Normal,2000 block of Lambert Dr,3,3,6
2097494,22-Aug-21,Colorado,Denver,19th St and Blake St,1,5,6
2097063,21-Aug-21,Illinois,Chicago,1600 block of E 87th Pl,1,5,6
2094071,18-Aug-21,Ohio,Youngstown,619 Samuel Ave,2,4,6
2087433,10-Aug-21,Oregon,Portland,NE Milton St,2,4,6
2086236,9-Aug-21,Michigan,Flint,3201 Hammerberg Rd,2,4,6
2086148,9-Aug-21,Massachusetts,Boston,27 Irma St,1,5,6
2085489,8-Aug-21,Texas,Houston,2504 FM 1960 Rd E,1,5,6
2079044,31-Jul-21,Ohio,Columbus,1662 W Mound St,1,5,6
2074353,25-Jul-21,Michigan,Detroit,16342 W McNichols Rd,0,6,6
2074406,25-Jul-21,California,Wasco,1718 1st St,5,1,6
2072962,24-Jul-21,Texas,Amarillo,1306 NE 3rd Ave,0,6,6
2072896,23-Jul-21,California,San Rafael,842 4th St,2,4,6
2071343,22-Jul-21,Texas,Houston,9717 N Houston Rosslyn Rd,1,5,6
2067728,19-Jul-21,New Jersey,Perth Amboy,417 Fayette St,0,6,6
2066189,17-Jul-21,Illinois,Chicago,5006 W Ohio St,0,6,6
2065634,16-Jul-21,California,Sacramento,L St and Front St,2,4,6
2064992,16-Jul-21,District of Columbia,Washington,2900 block of MLK Ave SE,1,5,6
2063495,15-Jul-21,Texas,Levelland,1105 10th St,1,5,6
2059440,11-Jul-21,Texas,El Paso (Socorro),1300 Joe Battle Blvd,1,5,6
2059404,10-Jul-21,Pennsylvania,Philadelphia,W Butler St and N 9th St,0,6,6
2053048,5-Jul-21,Illinois,Chicago,6108 S Wabash Ave,2,4,6
2053346,4-Jul-21,Texas,Dallas,8200 block of Towns St,3,3,6
2050151,1-Jul-21,South Carolina,Spartanburg,225 Amelia St,2,4,6
2046714,27-Jun-21,Illinois,Chicago,2000 block of E 71st St,1,5,6
2039346,19-Jun-21,Louisiana,Baton Rouge,7132 Florida Blvd,2,4,6
2036635,16-Jun-21,Maryland,Baltimore,2100 block of West Lexington St,1,5,6
2027736,7-Jun-21,Ohio,Cleveland,4100 block of E 81st St,0,6,6
2027046,7-Jun-21,Florida,Homestead,12550 SW 282nd St,3,3,6
2022391,2-Jun-21,Ohio,Springfield,1935 S Yellow Springs St,0,6,6
2022129,31-May-21,Ohio,Cleveland (Garfield Heights),13000 block of Alvin Ave,1,5,6
2013043,22-May-21,Ohio,Columbus,233 S Civic Center Dr,1,5,6
2011077,21-May-21,New York,Albany,1st St and Quail St,1,5,6
2011482,21-May-21,New Jersey,Jersey City,16 Brinkerhoff St,2,4,6
2006204,16-May-21,Georgia,Stone Mountain,4766 Redan Rd,1,5,6
1998067,7-May-21,Missouri,Saint Louis (Kinloch),5541 Mable Ave,2,4,6
1992534,1-May-21,Louisiana,New Orleans,St Bernard Ave and N Claiborne Ave,2,4,6
1990821,29-Apr-21,Georgia,Atlanta,2300 block of Polar Rock Terrace SW,1,5,6
1981805,19-Apr-21,Texas,Houston,700 E Whitney St,2,4,6
1980689,18-Apr-21,Wisconsin,Kenosha,1548 Sheridan Rd,3,3,6
1981521,18-Apr-21,Michigan,Detroit,Ward Ave and W McNichols Rd,1,5,6
1981353,18-Apr-21,Louisiana,Shreveport,3701 Hearne Ave,0,6,6
1980492,17-Apr-21,Ohio,Columbus,5001 Chatterton Rd,1,5,6
1978616,15-Apr-21,Florida,Pensacola,700 Truman Ave,0,6,6
1973844,9-Apr-21,Texas,Fort Worth,2000 block of SW Loop 820,1,5,6
1972187,8-Apr-21,Texas,Bryan,350 Stone City Dr,1,5,6
1969505,4-Apr-21,Louisiana,Monroe,207 Sterlington Rd,0,6,6
1968887,4-Apr-21,Alabama,Birmingham,3969 14th Ave N,1,5,6
1969221,3-Apr-21,Texas,Allen,1517 Pine Bluff Dr,6,0,6
1966181,31-Mar-21,California,Orange,202 West Lincoln Ave,4,2,6
1963598,28-Mar-21,Maryland,Essex,1601 Middleborough Rd,5,1,6
1962934,27-Mar-21,Mississippi,Yazoo City,Dr Martin Luther King Jr Dr and Shady Dr,0,6,6
1957252,20-Mar-21,Pennsylvania,Philadelphia,4234 Germantown Ave,1,5,6
1951738,13-Mar-21,Virginia,Richmond,5100 block of Richmond Henrico Tpke,2,4,6
1941382,28-Feb-21,Ohio,Cincinnati,3600 block of Idlewild Ave,3,3,6
1940069,26-Feb-21,Texas,Houston,8708 Beechnut St,1,5,6
1928557,13-Feb-21,California,San Francisco,3rd St and Quesada Ave,0,6,6
1928149,13-Feb-21,California,Oakland,1000 block of Washington St,0,6,6
1921768,6-Feb-21,Illinois,Bloomingdale,250 W Schick Rd,1,5,6
1917918,2-Feb-21,Florida,Fort Lauderdale (Sunrise),10100 Reflections Blvd W,3,3,6
1910136,24-Jan-21,Indiana,Indianapolis,3540 Adams St,5,1,6
1896252,6-Jan-21,Virginia,Manassas,10010 Ellis Rd,3,3,6
1893754,3-Jan-21,Florida,Miami,3632 NW 25th Ave,0,6,6
1886974,26-Dec-20,Illinois,Rockford,4007 E State St,3,3,6
1887059,26-Dec-20,Massachusetts,Lynn,Washington St and Quincy Ter,1,5,6
1881213,19-Dec-20,Illinois,Chicago,8936 S Cottage Grove Ave,0,6,6
1908063,8-Dec-20,West Virginia,Williamsburg,611 Flynns Creek Rd,6,0,6
1870827,6-Dec-20,Texas,Venus,6100 N FM 157,0,6,6
1870840,5-Dec-20,North Carolina,Autryville,10101 Gip Rd,0,6,6
1862947,27-Nov-20,Georgia,Macon,425 Cherry St,1,5,6
1863099,27-Nov-20,Ohio,Toledo,3257 Stickney Ave,0,6,6
1862603,26-Nov-20,Nevada,Henderson,870 E Lake Mead Pkwy,1,5,6
1857439,21-Nov-20,Illinois,Chicago,W 79th St and S Justine St,0,6,6
1850981,12-Nov-20,Florida,Tampa,1200 block of E Palifox St,2,4,6
1850693,12-Nov-20,North Carolina,Gastonia,1225 Union Rd,0,6,6
1840534,1-Nov-20,South Carolina,Hollywood,7800 block of White Point Rd,0,6,6
1830875,21-Oct-20,New York,Brooklyn,Nostrand Ave and Hawthorne St,1,5,6
1826680,17-Oct-20,New York,Lockport,43 S Niagara St,1,5,6
1826444,16-Oct-20,California,San Jose,175 S Capitol Ave,2,4,6
1814148,4-Oct-20,Georgia,Atlanta,1570 Joseph E Boone Blvd NW,1,5,6
1807325,28-Sep-20,Michigan,Detroit,6609 Michigan Ave,0,6,6
1796684,15-Sep-20,California,San Jose,600 block of S 8th St,2,4,6
1794138,13-Sep-20,Tennessee,Beechgrove,I-24 and Beech Grove Rd,3,3,6
1792650,12-Sep-20,Illinois,Chicago,100 block of N Pine Ave,2,4,6
1787286,6-Sep-20,Missouri,Kansas City,3999 Swope Pkwy,0,6,6
1785713,5-Sep-20,Florida,Williston,Co Rd 318 and US-27 Alt,0,6,6
1785108,3-Sep-20,Pennsylvania,Philadelphia,700 block of E Chelten Ave,0,6,6
1778571,29-Aug-20,Illinois,Rock Island,1800 2nd Ave,1,5,6
1772934,23-Aug-20,Colorado,Pueblo,2000 block of Longhorn Point,0,6,6
1769489,19-Aug-20,Illinois,Chicago,8500 block of S Parnell Ave,0,6,6
1766380,16-Aug-20,Colorado,Denver,W Alameda Ave and S Federal Blvd,2,4,6
1765705,15-Aug-20,Connecticut,New Haven,Rosette St and Hurlburt St,1,5,6
1759779,9-Aug-20,Ohio,Toledo,Monroe St and N Detroit Ave,0,6,6
1758838,8-Aug-20,Pennsylvania,Philadelphia,1101 N 38th St,0,6,6
1759237,8-Aug-20,Alabama,Birmingham (Ensley),426 18th St,1,5,6
1754672,4-Aug-20,Connecticut,Hartford,818 Windsor St,1,5,6
1746582,25-Jul-20,Michigan,Flint,4813 Clio Rd,0,6,6
1744332,23-Jul-20,Illinois,Chicago,120th St and Prairie Ave,2,4,6
1735326,15-Jul-20,New York,Brooklyn,President St and Franklin Ave,1,5,6
1733702,13-Jul-20,New York,Brooklyn,Remsen Ave,0,6,6
1734058,13-Jul-20,Washington,Kent,23201 Pacific Hwy South,0,6,6
1732532,12-Jul-20,Mississippi,Como,2965 Hunter Chapel Road,2,4,6
1731349,11-Jul-20,New York,Rochester,485 N Clinton Ave,0,6,6
1727567,6-Jul-20,Illinois,Chicago,1305 W 76th St,0,6,6
1725145,5-Jul-20,Illinois,Chicago,1500 block of S Millard Ave,1,5,6
1726034,5-Jul-20,Illinois,Freeport,900 block of S Carroll Ave,1,5,6
1725571,5-Jul-20,Michigan,Detroit,San Juan Dr and W McNichols Rd,2,4,6
1704116,13-Jun-20,Missouri,Saint Louis,3103 N Grand Blvd,2,4,6
1703509,12-Jun-20,Pennsylvania,Philadelphia,N Broad St and Colwyn St,0,6,6
1703044,11-Jun-20,Louisiana,Monroe,1101 Richwood Road 2,6,0,6
1703055,11-Jun-20,Texas,Houston,5840 Glenmont Dr,2,4,6
1701714,10-Jun-20,California,Paso Robles,900 Park St,2,4,6
1699667,7-Jun-20,Illinois,Chicago,3700 block of S State St,0,6,6
1693340,31-May-20,Mississippi,Gulfport,S Carolina Ave and Polk St,1,5,6
1693246,30-May-20,Florida,Altha,21281 Apachee Rd,2,4,6
1692496,30-May-20,North Carolina,Gastonia,3000 block of Earl Ln,1,5,6
1687999,25-May-20,Louisiana,Lake Charles,6780 US-90,0,6,6
1687108,23-May-20,North Carolina,Charlotte,4900 Block of Albemarle Rd,0,6,6
1686747,23-May-20,Florida,Daytona Beach,13 S Atlantic Ave,0,6,6
1676746,10-May-20,Texas,Katy,18000 block of Bonners Park Cir,0,6,6
1656873,11-Apr-20,California,Bakersfield,Pioneer Rd and Sterling Rd,0,6,6
1635796,8-Mar-20,Maryland,Rosedale,6247 Kenwood Ave,1,5,6
1635118,6-Mar-20,District of Columbia,Washington,6219 Dix St NE,0,6,6
1634128,4-Mar-20,California,Tulare,111 W Tulare Ave,1,5,6
1629488,26-Feb-20,Wisconsin,Milwaukee,3939 W Highland Blvd,6,0,6
1622406,16-Feb-20,Connecticut,Hartford,451 Franklin Ave,1,5,6
1621821,14-Feb-20,Illinois,Chicago,6500 block of S King Dr,0,6,6
1612716,3-Feb-20,California,Lebec,8968 Grapevine Rd,1,5,6
1605770,26-Jan-20,North Carolina,Salisbury,1935 Jake Alexander Blvd,0,6,6
1605752,26-Jan-20,South Carolina,Hartsville,115 W Camden Ave,3,3,6
1579220,24-Dec-19,North Carolina,High Point,1226 Montlieu Ave,0,6,6
1556633,24-Nov-19,California,Los Angeles,100 block of E 11th St,0,6,6
1550546,16-Nov-19,California,San Diego,2152 Flintridge Dr,6,0,6
1548689,14-Nov-19,California,Santa Clarita,21900 Centurion Way,3,3,6
1525999,13-Oct-19,Pennsylvania,Philadelphia,W Clearfield St and N 8th St,0,6,6
1525265,12-Oct-19,Michigan,Eastpointe,15163 E 10 Mile Rd,1,5,6
1509510,21-Sep-19,Indiana,Indianapolis,101 W Maryland St,0,6,6
1508859,20-Sep-19,Louisiana,New Orleans,Canal Blvd and City Park Ave,1,5,6
1507939,19-Sep-19,District of Columbia,Washington,1300 block of Columbia Rd NW,1,5,6
1503192,12-Sep-19,New Mexico,Albuquerque,1028 Lura Pl SW,4,2,6
1492087,30-Aug-19,Alabama,Mobile,1621 Virginia St,0,6,6
1481989,17-Aug-19,Texas,Houston,12500 block of Mylla St,0,6,6
1478869,14-Aug-19,Pennsylvania,Philadelphia,3716 N 15th St,0,6,6
1475924,11-Aug-19,Illinois,Chicago,3500 block of W Lake St,0,6,6
1460630,28-Jul-19,Pennsylvania,Philadelphia,2600 block of Carroll St,1,5,6
1457165,25-Jul-19,California,Canoga Park,21901 Roscoe Boulevard,4,2,6
1441565,7-Jul-19,Michigan,Flint,Clio Rd and Myrtle St,0,6,6
1440510,5-Jul-19,Massachusetts,Boston,Maple St,0,6,6
1440879,5-Jul-19,Nevada,Reno,600 block of Spokane St,1,5,6
1435578,30-Jun-19,New York,Bay Shore,Farragut Ave,0,6,6
1423697,16-Jun-19,Pennsylvania,Philadelphia,6900 block of Reedbird Pl,1,5,6
1423435,16-Jun-19,Iowa,Des Moines,1200 block of Sampson St,0,6,6
1412430,1-Jun-19,Georgia,Macon,Suzanne Dr and Robinson Dr,2,4,6
1407189,27-May-19,New Jersey,Trenton,100 block of Walnut St,1,5,6
1399346,18-May-19,North Carolina,Winston Salem (Winston-salem),4252 Cody Drive,2,4,6
1392313,10-May-19,Missouri,Saint Louis,4000 block of Ashland Ave,0,6,6
1387170,5-May-19,California,Oceano,1001 Cabrillo Hwy,0,6,6
1383752,30-Apr-19,North Carolina,Charlotte,9214 South Library Ln,2,4,6
1381734,27-Apr-19,California,Los Angeles,700 N San Fernando Rd,0,6,6
1376873,20-Apr-19,Tennessee,Memphis,761 Chestnut Ave,0,6,6
1365173,7-Apr-19,Delaware,Wilmington,940 N Pine St,0,6,6
1364540,6-Apr-19,Illinois,Chicago,6300 block of S Seeley Ave,0,6,6
1353714,24-Mar-19,California,San Francisco,1300 Fillmore St,1,5,6
1350494,19-Mar-19,Arizona,Phoenix,8526 N 27th Ave,2,4,6
1348291,15-Mar-19,Alabama,Mobile,515 Dauphin Island Pkwy,2,4,6
1338765,3-Mar-19,Illinois,Chicago,2900 block of E 79th St,0,6,6
1329075,17-Feb-19,Louisiana,New Orleans,Tulane Ave and Elk Pl,1,5,6
1302060,16-Jan-19,Florida,Jacksonville,Emerson St and Spring Park Rd,1,5,6
1299680,13-Jan-19,Arizona,Phoenix,2445 E Van Buren St,1,5,6
1238603,22-Oct-18,Illinois,Chicago,9231 S Cottage Grove Av,0,6,6
1237930,21-Oct-18,Florida,Jacksonville,900 block of A Philip Randolph Blvd,1,5,6
1232044,12-Oct-18,South Carolina,Spartanburg,1620 John B White Sr Blvd,0,6,6
1226384,6-Oct-18,California,Oakland,Williams St and Telegraph Ave,0,6,6
1209006,12-Sep-18,California,Bakersfield,660 Manwell Blvd,6,0,6
1204538,6-Sep-18,Ohio,Cincinnati,511 Walnut St,4,2,6
1182717,8-Aug-18,Pennsylvania,Philadelphia,North 12th Street and West Huntingdon Street,2,4,6
1179619,5-Aug-18,Illinois,Chicago,1300 block of S Millard Ave,1,5,6
1179810,4-Aug-18,Nevada,Las Vegas,3400 block of Coran Ln,0,6,6
1180161,4-Aug-18,Missouri,Kansas City,E 18th St and Highland Ave,0,6,6
1174527,28-Jul-18,California,Los Angeles,8801 S Vermont Ave,2,4,6
1172403,26-Jul-18,Texas,Dallas,3019 South Blvd,0,6,6
1165214,16-Jul-18,Florida,Palm Beach Gardens (Riviera Beach),2100 block of W 28th St,2,4,6
1160418,8-Jul-18,Alabama,Brandon,565 US-80,0,6,6
1156528,5-Jul-18,California,Los Angeles,1600 block of W. 2nd Street,3,3,6
1156638,5-Jul-18,Virginia,Virginia Beach,1800 block of Atlantic Ave,0,6,6
1157733,5-Jul-18,Ohio,Lima,1440 Bellefontaine Ave,1,5,6
1155567,3-Jul-18,Missouri,Saint Louis,1700 block of Billups Ave,1,5,6
1153997,1-Jul-18,Illinois,Chicago,3400 block of W Walnut Ave,0,6,6
1153531,30-Jun-18,Maryland,Baltimore,4000 block of Penhurst Ave,0,6,6
1149910,25-Jun-18,Illinois,Chicago,3900 block of S Vincennes Ave,0,6,6
1138324,11-Jun-18,Florida,Orlando,4932 Eaglesmere Dr,6,0,6
1137435,10-Jun-18,California,Valley Village,12719 Tiara St,0,6,6
1137600,10-Jun-18,Florida,Bradenton,5627 14th St W,1,5,6
1137473,10-Jun-18,Illinois,Chicago,6400 block of S Eberhart Ave,1,5,6
1116705,16-May-18,Texas,Ponder,610 Lone Star Park Ln,5,1,6
1114276,12-May-18,Nebraska,Omaha,3201 Decatur St,0,6,6
1109322,6-May-18,Tennessee,Memphis,499 N Watkins St,2,4,6
1097700,22-Apr-18,Louisiana,New Orleans,1900 block of St Roch Ave,2,4,6
1096388,20-Apr-18,California,San Francisco,3rd Street and Quesada Ave,1,5,6
1092279,15-Apr-18,Louisiana,Shreveport,6956 Jewella Ave,0,6,6
1074886,21-Mar-18,California,San Francisco,949 Geneva Ave,1,5,6
1067061,11-Mar-18,Indiana,South Bend,800 block of E Dayton St,0,6,6
1044234,7-Feb-18,Florida,Lake Worth (Lantana),I-95 and W Lantana Rd,3,3,6
1043447,5-Feb-18,Colorado,Colorado Springs,4225 Galley Rd,2,4,6
1042280,3-Feb-18,Ohio,Cleveland (Garfield Heights),11321 Broadway Ave,1,5,6
1022067,7-Jan-18,Alabama,Union Springs,US-29,1,5,6
1021788,5-Jan-18,Mississippi,Hattiesburg,6168 US 49,0,6,6
995015,24-Nov-17,Ohio,Cleveland,11618 Buckeye Rd,1,5,6
985832,11-Nov-17,North Carolina,Fayetteville,2835 Bragg Blvd,1,5,6
986092,11-Nov-17,Louisiana,New Orleans,Forstall St and Burgundy St,1,5,6
974051,27-Oct-17,Kentucky,Louisville,1716 Prentice St,0,6,6
962359,18-Oct-17,Maryland,Edgewood,2111 Emmorton Park Rd,3,3,6
932526,13-Sep-17,Tennessee,Memphis,1000 block of Morehead St,1,5,6
922184,28-Aug-17,New Mexico,Clovis,701 N Main St,2,4,6
907555,6-Aug-17,New York,Bronx,Wickham Ave,0,6,6
904106,1-Aug-17,Washington,Toppenish,8000 Block of Lateral C Rd,0,6,6
901549,30-Jul-17,Virginia,Norfolk,1500 block of Azalea Garden Rd,1,5,6
866739,14-Jun-17,Virginia,Alexandria,420 E Monroe Ave,1,5,6
866933,14-Jun-17,California,San Francisco,720 San Bruno,4,2,6
863075,8-Jun-17,Louisiana,New Orleans,3650 Franklin Ave,0,6,6
859875,5-Jun-17,Florida,Orlando,2427 Forsyth Rd,6,0,6
853796,28-May-17,New Jersey,Paterson,86 Main Street,1,5,6
832309,30-Apr-17,South Carolina,Loris,268 N Sea Green Rd,1,5,6
831800,29-Apr-17,California,Whittier,10000 block of Carmentia Rd,1,5,6
821400,15-Apr-17,Alabama,Birmingham,1480 Center Point Pkwy,0,6,6
814094,7-Apr-17,Illinois,Chicago,5600 block of W Lake St,1,5,6
809978,2-Apr-17,Illinois,Chicago,3500 block of W Van Buren St,2,4,6
804115,27-Mar-17,Florida,Sanford,209 Hays Dr,2,4,6
803822,26-Mar-17,Texas,Houston,5619 Aldine Bender Rd,2,4,6
797553,19-Mar-17,Kentucky,Louisville,1512 Portland Avenue,1,5,6
785262,28-Feb-17,Ohio,Cincinnati,1700 of Casey Dr,0,6,6
772067,10-Feb-17,Louisiana,New Orleans,2nd St and Dryades St,1,5,6
760259,25-Jan-17,Illinois,Chicago,500 block of E 75th St,0,6,6
756801,21-Jan-17,Georgia,Jonesboro,6510 Tara Blvd,0,6,6
733599,25-Dec-16,New York,Mount Vernon,4 North 3rd Avenue,1,5,6
717873,3-Dec-16,California,Los Angeles,91st Street and Western Avenue,0,6,6
717616,2-Dec-16,New Jersey,Bloomfield,3 1st Ave,0,6,6
715101,30-Nov-16,Maryland,Baltimore,2901 Garrison Blvd,2,4,6
710732,26-Nov-16,Illinois,Chicago,8800 block of S Exchange Ave,1,5,6
709370,24-Nov-16,Kentucky,Louisville,4501 W Broadway,2,4,6
699033,12-Nov-16,California,Sacramento,8600 block of Ardith Drive,1,5,6
691113,1-Nov-16,Tennessee,Memphis,5200 block of Zodiac Rd,1,5,6
689020,30-Oct-16,Maryland,Capitol Heights,6862 Walker Mill Rd,3,3,6
688429,28-Oct-16,Mississippi,Jackson,200 block of Lorenz Blvd,0,6,6
683142,23-Oct-16,Oklahoma,Wellston,Highway 66 and N 3310 Rd,1,5,6
676686,15-Oct-16,Illinois,Rockford,7801 East State St,1,5,6
659289,17-Sep-16,Florida,Miami,20582 SW 119th Ave,0,6,6
653077,11-Sep-16,Louisiana,New Orleans,2349 S Claiborne Ave,1,5,6
652584,11-Sep-16,Missouri,Kansas City,500 block of Westport Rd,0,6,6
641732,29-Aug-16,New Jersey,Egg Harbor City,907 White Horse Pike,1,5,6
641419,28-Aug-16,Texas,Lubbock,2200 block of 17th St,0,6,6
640203,27-Aug-16,Florida,Miami,1900 block of NW 83rd Terr,2,4,6
604175,16-Jul-16,Tennessee,Clarksville,1348 College Street,0,6,6
572766,5-Jun-16,Arizona,Phoenix,8152 N Black Canyon Hwy,2,4,6
572696,5-Jun-16,Florida,Cape Coral,2600 block of Skyline Boulevard S,3,3,6
567673,29-May-16,New Jersey,Trenton,600 block of Martin Luther King Jr. Boulevard,0,6,6
554133,6-May-16,Maryland,Bethesda,7101 Democracy Blvd,3,3,6
546022,22-Apr-16,Georgia,Appling,3162 Johnson Drive,6,0,6
541987,16-Apr-16,Florida,Orlando,1100 block of Conley Street,2,4,6
501256,7-Feb-16,Mississippi,Pass Christian,Davis Avenue,2,4,6
494378,27-Jan-16,Virginia,Chesapeake,1401 N. George Washington Hwy,6,0,6
476321,31-Dec-15,Louisiana,New Orleans,1900 block of Amelia Street,0,6,6
433146,19-Oct-15,Illinois,Calumet City,300 Campbell Avenue,0,6,6
428215,10-Oct-15,Tennessee,Memphis,6135 Mount Moriah Road,0,6,6
417013,20-Sep-15,Oklahoma,Tulsa,Pine and Yale,0,6,6
416872,20-Sep-15,Illinois,Chicago,5700 block of South LaSalle,1,5,6
418318,17-Sep-15,South Dakota,Geddes,36705 379th Street,6,0,6
413001,13-Sep-15,Florida,Ocala,1910 South Pine Avenue,1,5,6
412487,12-Sep-15,New York,Rochester,36 Woodward Street,2,4,6
412529,12-Sep-15,Minnesota,Minneapolis,1st Ave. and N. 5th St.,0,6,6
409732,7-Sep-15,Indiana,Gary,9300 block of Sunrise,2,4,6
395844,16-Aug-15,Texas,Fort Worth,3651 Sycamore School Rd,0,6,6
382230,22-Jul-15,Missouri,Saint Louis,Fair Ave and Ashland Ave,0,6,6
377878,20-Jul-15,New York,Bronx,E. 153rd St. and the Grand Concourse,0,6,6
377047,19-Jul-15,Kentucky,Louisville,2928 W Kentucky St,0,6,6
369014,5-Jul-15,Louisiana,Shreveport,3500 block of Hearne Ave,0,6,6
367099,28-Jun-15,Illinois,Venice,1430 Broadway,0,6,6
365399,28-Jun-15,Delaware,Harrington,100 block of East St,0,6,6
333584,3-May-15,Texas,Houston,San Jacinto St and Elgin St,0,6,6
330611,27-Apr-15,New York,Brooklyn,1365 Flatbush Ave,2,4,6
468151,20-Mar-15,Texas,Lancaster,1500 block of Reynolds Street,1,5,6
308728,18-Mar-15,Arizona,Mesa,1504 West Main Street,1,5,6
299344,1-Mar-15,Michigan,Detroit,9855 Chalmers St,1,5,6
290510,8-Feb-15,Tennessee,Friendship,251 Dupree Rd,0,6,6
289146,5-Feb-15,Ohio,Beachwood (Warrensville Heights),20009 Harvard Ave,3,3,6
287529,1-Feb-15,New York,Syracuse,1217 West Fayette Street,0,6,6
283115,23-Jan-15,Massachusetts,Boston,954 Parker Street,0,6,6
273535,4-Jan-15,Virginia,Roanoke,3634 Shenandoah Ave NW,2,4,6
282186,22-Dec-14,New York,Webster,191 Lake Rd,4,2,6
227011,2-Dec-14,Missouri,Saint Louis,6000 block of Virginia Avenue,1,5,6
225036,26-Nov-14,California,San Francisco,Mission and 13th streets,0,6,6
223582,21-Nov-14,Pennsylvania,Pittsburgh,600 block of Miller Avenue,0,6,6
224746,16-Nov-14,Texas,El Paso,115 S. Durango,0,6,6
210363,24-Oct-14,Washington,Marysville,5611 108th St NE,5,1,6
201052,5-Oct-14,Michigan,Detroit,East 7 Mile Road and Sherwood Street,1,5,6
190599,14-Sep-14,Alaska,Anchorage,225 E Fifth,0,6,6
185430,3-Sep-14,California,Los Angeles,East 27th and Stanford ,0,6,6
175788,16-Aug-14,Utah,Salt Lake City,122 Pierpont Avenue,0,6,6
172205,10-Aug-14,District of Columbia,Washington,50 block of N St SW,0,6,6
172288,10-Aug-14,Georgia,Wrightsville,2455 Idylwild Dr,0,6,6
168307,2-Aug-14,Pennsylvania,Pittsburgh,Penn Avenue and 29th Street,1,5,6
161302,21-Jul-14,New Jersey,Irvington,36 Welland Avenue,0,6,6
154803,5-Jul-14,Texas,Houston,1700 Almeda-Genoa,0,6,6
152693,29-Jun-14,California,Los Angeles,1100 block of North Vermont Avenue,1,5,6
156245,9-Jun-14,New Jersey,Paterson,Rosa Parks Boulevard and Godwin Avenue,0,6,6
143723,7-Jun-14,South Carolina,Moncks Corner,Tish Lane,1,5,6
141382,1-Jun-14,Illinois,Chicago,West Ferdinand Street and North Lavergne Avenue ,1,5,6
132405,3-May-14,Texas,Houston,Gears Rd and Trickey Rd,0,6,6
127045,20-Apr-14,Illinois,Montgomery,1300 block of Jackson St,0,6,6
122136,5-Apr-14,Illinois,Chicago,4300 W Wilcox Street,1,5,6
113247,9-Mar-14,Texas,Austin,4900 block of West Race Avenue,0,6,6
113214,8-Mar-14,Illinois,Chicago,4900 West Race Ave,0,6,6
108649,20-Feb-14,California,Alturas,300 W 1st St,4,2,6
97407,16-Jan-14,Oklahoma,Ardmore,H St NE and Martin Luther King Blvd,2,4,6
95500,12-Jan-14,Louisiana,Tallulah,3600 block of Highway 80 W,0,6,6
496684,31-Dec-13,New York,Brooklyn,60 Glenmore Ave,0,6,6
496584,26-Dec-13,Louisiana,Lockport,313 Tenth St,3,3,6
492366,26-Oct-13,Connecticut,New Haven,85 Saint John St,1,5,6
480961,6-Oct-13,Pennsylvania,Philadelphia,54th St. and Florence Ave,1,5,6
480691,24-Sep-13,West Virginia,Huntington,300 W 7th Ave,0,6,6
480669,22-Sep-13,Michigan,Muskegon,149 Ottawa Ave,2,4,6
480071,15-Sep-13,Washington,Yakima,2209 W Nob Hill Blvd,0,6,6
479709,7-Sep-13,Indiana,Gary,9300 block of Sunrise Boulevard,2,4,6
490115,28-Jun-13,Illinois,Chicago,4800 block of North Sheridan Road,0,6,6
488505,21-Jun-13,Virginia,Norfolk,1225 Tidewater Drive,0,6,6
487659,10-Jun-13,Missouri,Saint Louis,4700 block of Highland Ave,0,6,6
484307,14-Apr-13,Arizona,Phoenix,12400 North 25th Avenue,2,4,6
478893,31-Dec-12,California,Lakewood,20700 block of Alburtis Avenue,1,5,6
2309711,23-May-22,South Carolina,North Charleston,7550 Dorchester Rd,0,5,5
2308096,21-May-22,Indiana,Goshen,1204 Rosemare Ct,2,3,5
2306277,18-May-22,Pennsylvania,Philadelphia,1500 block of Bouvier St,0,5,5
2302740,15-May-22,Texas,Houston,8729 Airline Dr,2,3,5
2303337,15-May-22,Texas,Amarillo,1003 N Fillmore St,1,4,5
2300713,12-May-22,Arkansas,Hot Springs National Park (Hot Springs),134 Convention Blvd,1,4,5
2300830,11-May-22,New Jersey,Paterson,36 Essex St,1,4,5
2298872,10-May-22,Maryland,Baltimore,2800 block of Boarman Ave,0,5,5
2298836,10-May-22,Illinois,Chicago,4800 block of S Ada St,1,4,5
2298092,9-May-22,Alabama,Tuscaloosa,4420 21st St,0,5,5
2296191,7-May-22,Kentucky,Lexington,1560 LaSalle Rd,2,3,5
2296064,5-May-22,Washington,Sunnyside,613 S 6th St,0,5,5
2293603,3-May-22,Louisiana,Baton Rouge,2100 block of North 39th St,0,5,5
2294477,3-May-22,Texas,Beaumont,3580 S Martin Luther King Jr Pkwy,0,5,5
2291578,1-May-22,Ohio,Springfield,Clifton Ave and Rice St,1,4,5
2291618,30-Apr-22,Georgia,Atlanta,445 Cleveland Ave SE,1,4,5
2289308,27-Apr-22,Louisiana,Opelousas,700 block of Mia St,2,3,5
2289610,27-Apr-22,Texas,San Antonio,3399 Wurzbach Rd,0,5,5
2286089,23-Apr-22,California,San Bernardino,1036 W Highland Ave,1,4,5
2285860,23-Apr-22,Georgia,Atlanta,135 Andrew Young International Blvd NW,0,5,5
2284819,22-Apr-22,District of Columbia,Washington,2900 block of Van Ness St NW,1,4,5
2283535,20-Apr-22,Minnesota,Duluth,715 E 12th St,5,0,5
2282256,17-Apr-22,Louisiana,Baldwin,Rosebud Rd and Baptiste St,0,5,5
2280017,16-Apr-22,New York,Syracuse,300 block of S Clinton St,1,4,5
2272394,6-Apr-22,Pennsylvania,Philadelphia,Griscom St and Arrott St,1,4,5
2264094,26-Mar-22,California,Hollister,Rustic St and Roble St,2,3,5
2257316,19-Mar-22,Virginia,Norfolk,320 Granby St,3,2,5
2257674,19-Mar-22,Virginia,Madison Heights,351 Old Wright Shop Rd,1,4,5
2257778,18-Mar-22,Louisiana,New Iberia,200 block of C V Jackson Dr,0,5,5
2254579,15-Mar-22,Alabama,Ozark,1001 US Hwy 231,0,5,5
2252792,13-Mar-22,South Carolina,Columbia,810 Pulaski St,1,4,5
2250540,9-Mar-22,Colorado,Aurora,3300 N Ouray St,1,4,5
2250151,8-Mar-22,Florida,Jacksonville,Duval Station Rd and Starratt Rd,1,4,5
2248066,6-Mar-22,Pennsylvania,Hazleton,182 S  Wyoming St,1,4,5
2247622,6-Mar-22,South Carolina,Chester,Powell Dr and Harvey Neely Rd,2,3,5
2243861,28-Feb-22,California,Sacramento,2041 Wyda Way,5,0,5
2235778,17-Feb-22,Texas,Houston,3000 Blodgett St,0,5,5
2232351,12-Feb-22,Tennessee,Murfreesboro,1644 Middle Tennessee Blvd,1,4,5
2228979,6-Feb-22,Illinois,Romeoville,735 N Center Blvd,0,5,5
2227035,4-Feb-22,Virginia,Blacksburg,109 N Main St,1,4,5
2225493,2-Feb-22,California,Oroville,410 Oro Dam Blvd E,1,4,5
2224788,1-Feb-22,Wisconsin,Milwaukee,1801 W Olive St,0,5,5
2222953,30-Jan-22,Florida,Winter Haven,Buckeye Loop Rd and MLK Blvd NE,1,4,5
2220985,27-Jan-22,District of Columbia,Washington,4400 Connecticut Ave,1,4,5
2217882,23-Jan-22,California,Inglewood,1300 block of North Park Ave,4,1,5
2214013,18-Jan-22,Florida,Miami,10702 NW 7th Ave,1,4,5
2214306,17-Jan-22,Texas,San Antonio,400 block of Spriggsdale Ave,1,4,5
2207406,9-Jan-22,Colorado,Colorado Springs,1960 Chelton Rd,2,3,5
2201629,1-Jan-22,Pennsylvania,Philadelphia,1600 block of Cecil B Moore Ave,1,4,5
2201876,1-Jan-22,South Carolina,Dillon,3261 Hwy 9,0,5,5
2197178,26-Dec-21,Virginia,Clear Brook,I-81 S and Visitor Center Loop,1,4,5
2192046,17-Dec-21,Maryland,Baltimore,1300 block of W North Ave,1,4,5
2190367,12-Dec-21,Florida,Tampa,Alaska Ave,0,5,5
2187077,10-Dec-21,Florida,Orlando,Jefferson St and Garden Ave,0,5,5
2186696,10-Dec-21,North Carolina,Charlotte,3100 block of Marney Ave,0,5,5
2177300,28-Nov-21,Illinois,Evanston,1950 Green Bay Rd,1,4,5
2177416,28-Nov-21,California,Lancaster,3500 block of Garnet Lane,5,0,5
2176653,28-Nov-21,Colorado,Aurora,1500 block of Dayton St,0,5,5
2172178,21-Nov-21,New Jersey,Passaic,Howe Ave and Lafayette Ave,0,5,5
2172657,21-Nov-21,Louisiana,Baton Rouge,4888 Plank Rd,1,4,5
2166750,14-Nov-21,Arizona,Tucson,1655 W Ajo Way,4,1,5
2163772,9-Nov-21,Louisiana,Hahnville (Killona),160 Killona Dr,1,4,5
2163617,9-Nov-21,South Dakota,Scotland,710 2nd St,3,2,5
2158417,3-Nov-21,Virginia,Norfolk,821 Whitaker Ln,3,2,5
2155172,30-Oct-21,Florida,Saint Petersburg,1079 62nd Ave S,1,4,5
2154283,29-Oct-21,New York,Poughkeepsie,32 Cannon St,0,5,5
2150037,24-Oct-21,Mississippi,Crenshaw,413 Jones St,2,3,5
2148891,23-Oct-21,California,Ontario,700 block of E Bonnie Brae Ct,1,4,5
2148282,22-Oct-21,Illinois,Chicago,7901 S Cottage Grove Ave,0,5,5
2145931,19-Oct-21,Wisconsin,Kenosha,610 40th Pl,3,2,5
2143889,17-Oct-21,Colorado,Colorado Springs,1865 N Academy Blvd,0,5,5
2142296,15-Oct-21,Alabama,Mobile,1621 Virginia St,0,5,5
2142092,14-Oct-21,Minnesota,Minneapolis,814 E Franklin Ave,1,4,5
2137321,10-Oct-21,South Carolina,Mc Coll (Mccoll),4181 Hwy 15-401,2,3,5
2137179,10-Oct-21,Illinois,Chicago,1565 N Milwaukee Ave,1,4,5
2137555,10-Oct-21,Delaware,Dover,1500 block of Nathaniel Mitchell Rd,1,4,5
2135498,7-Oct-21,Wisconsin,Milwaukee,2400 block of N 37th St,0,5,5
2135666,7-Oct-21,Louisiana,New Orleans,S Robertson St and Martin Luther King Jr Blvd,1,4,5
2131471,3-Oct-21,South Carolina,Bishopville,1113 Sumter Hwy,1,4,5
2128682,29-Sep-21,Illinois,Chicago,800 block of N Milwaukee Ave,0,5,5
2126747,27-Sep-21,New York,New York (Manhattan),3964 10th Ave,0,5,5
2125444,25-Sep-21,Tennessee,Athens,Co Rd 60,4,1,5
2124396,24-Sep-21,South Carolina,Aiken,749 Silver Bluff Rd,4,1,5
2121381,21-Sep-21,District of Columbia,Washington,2200 block of Alabama Ave SE,0,5,5
2119609,19-Sep-21,Illinois,Chicago,900 block of N Massasoit Ave,0,5,5
2119478,18-Sep-21,Louisiana,Opelousas,500 block of Sapphire St,0,5,5
2115522,13-Sep-21,Wisconsin,Milwaukee,3073 N Sherman Blvd,0,5,5
2114510,11-Sep-21,Alabama,Dothan,2000 Reeves St,0,5,5
2109075,6-Sep-21,Georgia,Atlanta,868 Joseph E Boone Blvd NW,0,5,5
2108406,4-Sep-21,Georgia,Warner Robins,Mauldon Ct and Dunmurry Pl,1,4,5
2107476,4-Sep-21,Illinois,Chicago,1400 block of S Tripp Ave,0,5,5
2103256,29-Aug-21,Tennessee,Nashville,2621 Jefferson St,0,5,5
2103132,28-Aug-21,New York,Albany,Sherman St and Henry Johnson Blvd,0,5,5
2102082,27-Aug-21,Pennsylvania,Sharon Hill,300 Calcon Hook Rd,1,4,5
2097075,22-Aug-21,Illinois,Chicago,3400 block of W Lake St,1,4,5
2098321,22-Aug-21,Oregon,Portland,322 NW Everett St,0,5,5
2095087,19-Aug-21,Pennsylvania,Philadelphia,5100 block of Germantown Ave,1,4,5
2093581,17-Aug-21,New York,Brooklyn,422 Mother Gaston Blvd,0,5,5
2091597,15-Aug-21,Texas,San Antonio,1621 S New Braunfels Ave,3,2,5
2090971,14-Aug-21,Ohio,Akron,271 Maiden Ln,0,5,5
2090777,14-Aug-21,Indiana,Indianapolis,Lafayette Rd and W 38th St,1,4,5
2088659,11-Aug-21,Pennsylvania,Philadelphia,5500 Rising Sun Ave,1,4,5
2085396,8-Aug-21,New York,Brooklyn,101 Wortman Ave,3,2,5
2085401,8-Aug-21,Illinois,Chicago,8300 block of S Halsted St,1,4,5
2085542,8-Aug-21,Louisiana,New Orleans,700 block of Bourbon St,0,5,5
2080536,1-Aug-21,Rhode Island,Providence,77 Reservoir Ave,0,5,5
2079913,1-Aug-21,Louisiana,New Orleans,Bourbon St and Orleans Ave,0,5,5
2079271,31-Jul-21,Indiana,Indianapolis,1134 W 30th St,0,5,5
2081480,31-Jul-21,Ohio,Cleveland,3100 block of W 25th St,0,5,5
2079533,31-Jul-21,Kentucky,Lexington,414 East 5th St,0,5,5
2077587,29-Jul-21,Pennsylvania,Pittsburgh,239 Gilkeson Rd,3,2,5
2076889,28-Jul-21,South Carolina,Charleston,Hanover St and Johnson St,1,4,5
2073472,25-Jul-21,Illinois,Chicago,4800 block of W Race Ave,0,5,5
2073597,25-Jul-21,Washington,Seattle,100 block of Occidental Ave S,2,3,5
2072761,24-Jul-21,Georgia,Macon,Cherry St and Martin Luther King Jr Blvd,2,3,5
2070329,21-Jul-21,Illinois,Chicago,1400 block of S Ridgeway Ave,0,5,5
2069490,21-Jul-21,Maryland,Hyattsville (Adelphi),1836 Metzerott Rd,1,4,5
2070310,21-Jul-21,Illinois,Chicago,3300 block of W Douglas Blvd,2,3,5
2067135,18-Jul-21,Florida,Gainesville,1634 NE 8th Ave,1,4,5
2067290,18-Jul-21,Texas,Houston,3421 Antoine Dr,3,2,5
2065009,16-Jul-21,Pennsylvania,Philadelphia,2700 block of Ruby Terr,1,4,5
2065118,16-Jul-21,Illinois,Chicago,647 N Lockwood Ave,1,4,5
2063897,15-Jul-21,Missouri,Lake Ozark,1312 Bagnell Dam Blvd,1,4,5
2062097,14-Jul-21,Illinois,Chicago,4600 block of W Monroe St,0,5,5
2062359,14-Jul-21,Illinois,Chicago,1533 W 79th St,0,5,5
2060706,12-Jul-21,Pennsylvania,Beaver Falls,900 9th St,2,3,5
2053365,4-Jul-21,Texas,Dallas,3700 Dixon Ave,0,5,5
2053563,4-Jul-21,Illinois,Rantoul,400 block of S Maplewood Dr,0,5,5
2052342,4-Jul-21,Nebraska,Omaha,2311 N 24th St,1,4,5
2051190,2-Jul-21,Pennsylvania,Philadelphia,7700 block of Ogontz Ave,1,4,5
2050972,2-Jul-21,Illinois,Champaign,704 N Hickory St,1,4,5
2044701,25-Jun-21,New York,Bronx,Zerega Ave and Watson Ave,0,5,5
2044733,24-Jun-21,Florida,Gainesville,4701 NW 6th St,1,4,5
2040265,20-Jun-21,Colorado,Aurora,12455 E Mississippi Ave,1,4,5
2040243,20-Jun-21,Indiana,Granger,7321 Heritage Square Dr,1,4,5
2039457,19-Jun-21,Alaska,Anchorage,East 3rd Ave and Gambell St,1,4,5
2039441,18-Jun-21,Minnesota,Minneapolis,400 block of 14th Ave SE,0,5,5
2036121,15-Jun-21,Illinois,Chicago,3800 block of W Monroe,0,5,5
2035313,15-Jun-21,Alabama,Albertville,956 Industrial Blvd,3,2,5
2033123,12-Jun-21,Ohio,Cincinnati,McHenry Ave and Cavanaugh Ave,0,5,5
2032282,11-Jun-21,Texas,Dallas,378 N Jim Miller Rd,0,5,5
2030708,10-Jun-21,Illinois,Chicago,6530 S Claremont Ave,1,4,5
2028745,8-Jun-21,Tennessee,Memphis,2246 Eldridge Ave,1,4,5
2028928,8-Jun-21,Texas,Houston,4115 Washington Ave,0,5,5
2027375,6-Jun-21,California,Oakland,5100 block of Ygnacio Ave,0,5,5
2026713,6-Jun-21,Utah,Salt Lake City,1359 N General Dr,1,4,5
2019751,30-May-21,Alabama,Aliceville,7th Street NE,1,4,5
2018495,27-May-21,North Carolina,Durham,1200 block of Fayetteville St,0,5,5
2013059,23-May-21,New Jersey,Paterson,Hillman St and E Main St,0,5,5
2011610,22-May-21,Indiana,Fort Wayne,2177 Eden St,1,4,5
2008415,18-May-21,California,Hemet,1200 block of Valencia Ave,1,4,5
2005671,16-May-21,Michigan,East Lansing,6170 Abbot Rd,0,5,5
2005813,16-May-21,Alabama,Birmingham,1010 18th St S,1,4,5
2005196,15-May-21,New York,Bronx,1625 Webster Ave,1,4,5
2004666,15-May-21,Illinois,Chicago,7800 block of S Loomis St,2,3,5
1999417,9-May-21,Pennsylvania,Philadelphia,100 block of E Albanus St,2,3,5
2000132,9-May-21,South Carolina,Charleston,500 Block of King St,0,5,5
1998476,8-May-21,Maryland,Gwynn Oak (Woodlawn),7300 block of Maury Rd,4,1,5
1999434,6-May-21,New Jersey,Paterson,22nd Ave and E 30th St,0,5,5
1993551,3-May-21,Michigan,Saginaw,1315 Randolph St,1,4,5
1993280,2-May-21,Illinois,Chicago,2100 block of W Adams St,0,5,5
1992410,1-May-21,New York,New Rochelle,Horton Ave and Brook St,1,4,5
1992490,1-May-21,Massachusetts,Holyoke,209 South St,0,5,5
1990600,28-Apr-21,Florida,Miami,2100 block of NW 85th St,0,5,5
1989840,28-Apr-21,North Carolina,Boone,553 Hardaman Cir,5,0,5
1988688,27-Apr-21,Virginia,Richmond,4000 Midlothian Turnpike,2,3,5
1989023,27-Apr-21,Alabama,Fairfield,200 block of Glen Crest Dr,1,4,5
1987241,26-Apr-21,Louisiana,Houma,656 Corporate Dr,0,5,5
1986770,25-Apr-21,Missouri,Kansas City,E 18th St and Vine St,1,4,5
1985432,24-Apr-21,Louisiana,New Orleans,100 block of Bourbon St,0,5,5
1984807,22-Apr-21,California,San Diego,500 block of J St,1,4,5
1982260,19-Apr-21,Georgia,Atlanta,1191 Oakland Ln SW,0,5,5
1982020,18-Apr-21,Alabama,Montgomery,2300 block of Day St,1,4,5
1970937,7-Apr-21,Wisconsin,Milwaukee,2627 W Capitol Dr,2,3,5
1969065,5-Apr-21,Maryland,Baltimore,300 block of N Eutaw St,0,5,5
1967893,3-Apr-21,Alabama,Tuscaloosa,2314 4th St,0,5,5
1965890,31-Mar-21,District of Columbia,Washington,1300 block of Congress St SE,2,3,5
1962890,26-Mar-21,Tennessee,Memphis,500 block of Arrington Ave,3,2,5
1957188,20-Mar-21,Texas,Houston,10266 North Fwy,0,5,5
1956001,17-Mar-21,California,Stockton,Oro Ave and E Main St,0,5,5
1954950,16-Mar-21,Arizona,Phoenix,6215 W Elm St,4,1,5
1953309,15-Mar-21,Indiana,Indianapolis,2300 block of N Harding St,1,4,5
1952151,13-Mar-21,New York,Brooklyn,917 Flushing Ave,0,5,5
1952161,13-Mar-21,Indiana,Indianapolis,300 block of N Randolph St,4,1,5
1947241,6-Mar-21,California,Yuba City,Countryside Dr and Littlejohn Dr,2,3,5
1945999,6-Mar-21,North Carolina,Fayetteville,200 block of Shads Ford Blvd,1,4,5
1946991,5-Mar-21,California,Compton,600 block of N Long Beach Blvd,1,4,5
1944507,4-Mar-21,District of Columbia,Washington,3900 Martin Luther King Jr Ave SW,0,5,5
1943986,3-Mar-21,Pennsylvania,Erie,2105 Buffalo Rd,2,3,5
1941444,28-Feb-21,Louisiana,Shreveport,4914 Mansfield Rd,0,5,5
1940190,27-Feb-21,Mississippi,Pattison,Pattison-Tillman Rd,2,3,5
1934704,21-Feb-21,Missouri,Kennett,1615 1st St,1,4,5
1934225,20-Feb-21,Pennsylvania,Norristown (East Norriton),2912 Swede Rd,1,4,5
1934077,20-Feb-21,Louisiana,Metairie,6719 Airline Dr,3,2,5
1934181,20-Feb-21,Illinois,Springfield,1100 block of S Grand Ave W,1,4,5
1926742,11-Feb-21,Georgia,Columbus,2001 South Lumpkin Rd,1,4,5
1924338,9-Feb-21,Minnesota,Buffalo,755 Crossroads Campus Dr,1,4,5
1921939,6-Feb-21,Tennessee,Murfreesboro,Ewing Blvd and West St,1,4,5
1920771,4-Feb-21,North Carolina,High Point,2912 W English Rd,2,3,5
1919696,3-Feb-21,Colorado,Oak Creek,200 block of Wild Hogg Dr,3,2,5
1916374,30-Jan-21,New York,Albany,200 block of Central Ave,1,4,5
1914798,29-Jan-21,Pennsylvania,Mc Kees Rocks (Mckees Rocks),824 Island Ave,2,3,5
1914942,28-Jan-21,Michigan,Flint,1900 block of Tebo St,1,4,5
1911026,25-Jan-21,District of Columbia,Washington,1406 Good Hope Rd SE,1,4,5
1910619,24-Jan-21,Nevada,Las Vegas,W Wilson Ave and H St,0,5,5
1909849,22-Jan-21,Kentucky,Covington,217 E Martin Luther King Jr Blvd,0,5,5
1904063,17-Jan-21,Arizona,Phoenix,2340 W Northern Ave,0,5,5
1905360,16-Jan-21,Illinois,Kankakee,600 block of N Evergreen Ave,0,5,5
1896774,7-Jan-21,District of Columbia,Washington,1300 block of Columbia Rd NW,0,5,5
1894979,4-Jan-21,Florida,Tampa,1225 S 78th St,0,5,5
1893327,3-Jan-21,Texas,Houston,2900 Travis St,1,4,5
1893601,3-Jan-21,Louisiana,Shreveport,6900 block of Jewella Ave,2,3,5
1892114,1-Jan-21,Iowa,Sioux City,2637 S Walker St,1,4,5
1886372,25-Dec-20,Florida,Boynton Beach,Martin Luther King Jr Blvd and N Seacrest Blvd,1,4,5
1886721,25-Dec-20,Arkansas,Atkins,5180 Pine Ridge Rd,5,0,5
1886141,24-Dec-20,Florida,Lakeland,1500 block of Amos Ave,1,4,5
1885251,22-Dec-20,Mississippi,Meridian,Jeffrey Acres Rd,5,0,5
1877122,10-Dec-20,Mississippi,Jackson,1805 Hospital Dr,0,5,5
1873798,8-Dec-20,Louisiana,Lacombe,28399 Palmer Dr,2,3,5
1865110,29-Nov-20,Tennessee,Memphis,3492 W Metropolitan Cir,2,3,5
1864205,28-Nov-20,South Carolina,Conway,3800 block of Golden Key Rd,0,5,5
1857947,21-Nov-20,Arizona,Phoenix,35th Ave and Earll Dr,1,4,5
1855276,18-Nov-20,Texas,Houston,11614 Manor Park Dr,3,2,5
1852831,15-Nov-20,Louisiana,Shreveport,300 block of Douglas St,0,5,5
1852363,14-Nov-20,California,Riverside,La Sierra Avenue and Tin Mine Road,2,3,5
1844573,5-Nov-20,Ohio,Toledo,2125 Parkwood Ave,3,2,5
1842362,3-Nov-20,Nevada,Henderson,1445 Stonelake Cove Ave,4,1,5
1842421,2-Nov-20,Ohio,Mansfield,136 Sturges Ave,0,5,5
1840310,1-Nov-20,New Jersey,Atlantic City,2721 Arctic Ave,1,4,5
1839576,31-Oct-20,Washington,Sumner,127th Ave E and Valley Ave E,0,5,5
1834216,25-Oct-20,Texas,Fort Worth,1900 block of Carver Ave,2,3,5
1832977,22-Oct-20,Louisiana,Rayne,I-10,0,5,5
1829132,19-Oct-20,Ohio,Mansfield,136 Sturges Ave,0,5,5
1828080,18-Oct-20,Illinois,Chicago,200 block of N Sacramento Blvd,1,4,5
1826613,17-Oct-20,South Carolina,Rock Hill,524 N Anderson Rd,0,5,5
1821574,12-Oct-20,South Carolina,Myrtle Beach,1012 US-501,2,3,5
1816799,7-Oct-20,Alaska,Anchorage,200 block of McCarrey St,1,4,5
1813306,3-Oct-20,Tennessee,Clarksville,100 block of Tiny Town Rd,0,5,5
1812049,1-Oct-20,Michigan,Detroit,15018 Houston Whittier St,0,5,5
1809910,29-Sep-20,Pennsylvania,Philadelphia,4500 block of N 19th St,0,5,5
1806368,26-Sep-20,Missouri,Saint Louis,4700 block of Vernon Ave,0,5,5
1802862,23-Sep-20,Minnesota,Minneapolis,200 W Broadway Ave,0,5,5
1800886,21-Sep-20,Ohio,Struthers,111 Perry St,1,4,5
1800026,19-Sep-20,New York,Buffalo,Glenwood Ave and Jefferson Ave,1,4,5
1800192,19-Sep-20,New Jersey,Paterson,Elizabeth St and Getty Ave,0,5,5
1800779,19-Sep-20,Arkansas,West Memphis,900 block of Winchell St,0,5,5
1797620,16-Sep-20,Pennsylvania,Philadelphia,1800 Wallace St,2,3,5
1796638,15-Sep-20,Illinois,Chicago,3500 block of W Lawrence Ave,0,5,5
1793680,12-Sep-20,North Carolina,Wilson,200 block of Dewey St,0,5,5
1792624,11-Sep-20,Louisiana,Donaldsonville,St Elizabeth St and Front St,0,5,5
1791482,10-Sep-20,Louisiana,New Orleans,4100 block of Rayne Dr,3,2,5
1788401,8-Sep-20,Maryland,Baltimore,2300 block of Greenmount Ave,0,5,5
1787655,7-Sep-20,New York,Brooklyn,Norstrand Ave and Crown St,0,5,5
1787222,7-Sep-20,Indiana,Indianapolis,W 38th St and Graceland Ave,1,4,5
1787006,6-Sep-20,Louisiana,New Iberia,1752 Center St,0,5,5
1825993,31-Aug-20,Pennsylvania,Philadelphia,1500 block of W Clearfield St,0,5,5
1779981,30-Aug-20,New York,Buffalo,500 block of Fillmore Ave,1,4,5
1779718,30-Aug-20,Illinois,Chicago,11601 S Western Ave,1,4,5
1780091,30-Aug-20,Kentucky,Madisonville,400 block of Elm St,0,5,5
1779023,28-Aug-20,Texas,Dallas,2600 block of Elm St,1,4,5
1776189,25-Aug-20,Virginia,Norfolk,800 block of E Princess Anne Rd,0,5,5
1773996,24-Aug-20,Virginia,Richmond,2300 block of Bethel St,1,4,5
1772680,23-Aug-20,Tennessee,Somerville,1100 block of Brewer Rd,1,4,5
1768125,18-Aug-20,Pennsylvania,Philadelphia,3000 block of Cumberland St,1,4,5
1768683,17-Aug-20,Ohio,Cleveland,Dove Ave and E 102nd St,0,5,5
1767402,17-Aug-20,Texas,Dayton,County Rd 4901,3,2,5
1765499,15-Aug-20,Pennsylvania,Philadelphia,N 10th St and Brown St,0,5,5
1765890,15-Aug-20,New York,Rochester,501 Thurston Rd,0,5,5
1764756,15-Aug-20,Alabama,Troy,4100 US-231 S,2,3,5
1762951,12-Aug-20,New Jersey,Newark,N 12th St,1,4,5
1761557,11-Aug-20,California,Torrance,22904 Lockness Ave,0,5,5
1759425,8-Aug-20,Kentucky,Paducah,900 block of Boyd St,1,4,5
1759439,8-Aug-20,Massachusetts,Brockton,124 Laureston St,0,5,5
1754613,4-Aug-20,California,Beverly Hills,13200 Mulholland Dr,1,4,5
1753561,2-Aug-20,New Jersey,Newark,200 block of 6th Ave,0,5,5
1752100,1-Aug-20,Illinois,Chicago,100 block of N Laporte Ave,1,4,5
1753235,1-Aug-20,Texas,Pointblank,4411 Counts Rd,2,3,5
1751949,1-Aug-20,Colorado,Denver,3000 block of W Virginia Ave,1,4,5
1750611,30-Jul-20,Florida,Tampa,I-275 and N Westshore Blvd,0,5,5
1750548,30-Jul-20,Florida,Miami Gardens,16701 NW 42 Ave,0,5,5
1749873,29-Jul-20,Ohio,Elyria,537 Willow Park Rd,5,0,5
1749746,29-Jul-20,Missouri,Saint Louis,5500 block of Floy Ave,3,2,5
1747700,27-Jul-20,Illinois,Chicago,705 E 92nd Pl,1,4,5
1746430,25-Jul-20,Colorado,Denver,East 33rd Ave and Hudson St,2,3,5
1740533,20-Jul-20,Virginia,Richmond,6850 Forest Hill Ave,1,4,5
1740615,20-Jul-20,Illinois,Chicago,S Lawndale Ave and W Douglas Blvd,0,5,5
1740013,19-Jul-20,Illinois,Chicago,11300 block of South Carpenter St,2,3,5
1738635,18-Jul-20,Illinois,Chicago,1600 block of S Keeler Ave,1,4,5
1736508,16-Jul-20,Tennessee,Nashville,S 7th St and Sylvan St,0,5,5
1735573,14-Jul-20,Missouri,Saint Joseph,S 18th St and Charles St,0,5,5
1732688,12-Jul-20,Michigan,Lansing,3029 BeauJardin Dr,0,5,5
1732229,12-Jul-20,Illinois,Chicago,1100 block of N Lawndale Ave,1,4,5
1732321,11-Jul-20,Delaware,Wilmington,600 block of N Pine St,0,5,5
1727743,7-Jul-20,Virginia,Alexandria,7900 block of Janna Lee Ave,0,5,5
1725167,5-Jul-20,New York,New York (Manhattan),549 Academy St,0,5,5
1725946,5-Jul-20,Missouri,Columbia,Volunteer Dr and Grace Ln,2,3,5
1725670,4-Jul-20,Georgia,Atlanta,1600 block of Lakewood Ave,0,5,5
1725407,4-Jul-20,Massachusetts,Lynn,134 Fayette St,1,4,5
1724231,4-Jul-20,Michigan,Detroit,8340 Homer St,2,3,5
1725735,4-Jul-20,South Carolina,Barnwell,N/A,0,5,5
1723184,2-Jul-20,California,Delano,2100 block of Oleander St,2,3,5
1722839,2-Jul-20,New Jersey,Paterson,N Main St and Jefferson St,1,4,5
1721964,30-Jun-20,Iowa,Davenport,1400 block of Pershing Ave,0,5,5
1720781,30-Jun-20,Georgia,Atlanta,Parkway Dr,1,4,5
1717828,26-Jun-20,Colorado,Aurora,698 Peoria St,0,5,5
1715231,23-Jun-20,Florida,Lake Worth,Lantana Rd and Edgecliff Ave,0,5,5
1713075,22-Jun-20,California,San Francisco,200 block of Leavenworth St,0,5,5
1713790,22-Jun-20,New York,Brooklyn,Sterling St and Brooklyn Ave,0,5,5
1712408,22-Jun-20,Illinois,Chicago,200 S Central Park Blvd,0,5,5
1713668,22-Jun-20,Ohio,Columbus,1910 Fountainview Ct,1,4,5
1711626,21-Jun-20,Texas,Austin,500 block of E 7th St,0,5,5
1711605,21-Jun-20,Wisconsin,Milwaukee,North 28th St and West Ruby Ave,0,5,5
1710680,20-Jun-20,New Jersey,Jersey City,Union St and Ocean Ave,1,4,5
1710849,20-Jun-20,Wisconsin,Janesville,6530 S US-51,0,5,5
1711397,20-Jun-20,Kansas,Wichita,3741 N Rock Rd,0,5,5
1704862,14-Jun-20,Kentucky,Louisville,531 Franklin St,1,4,5
1704873,14-Jun-20,Louisiana,Lafayette,400 block of Jefferson St,0,5,5
1705440,13-Jun-20,California,Hesperia,8100 block of Julie Ct,0,5,5
1704176,13-Jun-20,Maryland,Baltimore,700 block of S Broadway St,0,5,5
1702372,10-Jun-20,California,Sacramento,68th Avenue and Della Circle,1,4,5
1700864,9-Jun-20,North Carolina,Scotland Neck,E 13th St and Greenwood St,0,5,5
1701491,9-Jun-20,California,Vallejo,100 block of Cynthia Ave,2,3,5
1699193,7-Jun-20,Tennessee,Dyersburg,1305 Grant St,0,5,5
1699577,7-Jun-20,Arkansas,Hope,1400 block of East Hickory St,0,5,5
1698868,6-Jun-20,California,Sacramento,Gardendale Rd and 29th St,1,4,5
1698306,6-Jun-20,Missouri,Kansas City,E 18th St and Vine St,1,4,5
1700812,6-Jun-20,Mississippi,Drew,Wilson Ave,0,5,5
1695586,2-Jun-20,Wisconsin,Racine,Kewaunee St and Michigan Blvd,0,5,5
1693064,30-May-20,Texas,Houston,9635 Scott St,1,4,5
1692102,29-May-20,Virginia,Portsmouth,500 block of Edwards St,0,5,5
1690369,27-May-20,Massachusetts,Boston,5 Ames St,1,4,5
1690439,27-May-20,California,San Jose,1100 block of William Ct,0,5,5
1689555,26-May-20,California,Los Angeles,119th St and Berendo Ave,0,5,5
1686615,23-May-20,Illinois,Rock Island,800 14 1/2 St,1,4,5
1686414,23-May-20,Florida,Fort Lauderdale (Lauderhill),7776 NW 44th St,0,5,5
1687381,23-May-20,Mississippi,Jackson,2300 block of Oakhurst Dr,1,4,5
1683810,20-May-20,Texas,Houston,6918 Landor St,2,3,5
1683653,19-May-20,Illinois,Decatur,300 block of West Leafland Ave,0,5,5
1682322,18-May-20,California,Bakersfield,901 W Columbus St,0,5,5
1682233,17-May-20,South Carolina,Saint Matthews,100 block of Bugleflower Ln,4,1,5
1686369,15-May-20,Florida,Gainesville,2305 SE Hawthorne Rd,0,5,5
1680027,14-May-20,New Mexico,Albuquerque,820 Louisiana SE,0,5,5
1679086,13-May-20,Illinois,Rockford,2914 W State St,1,4,5
1678589,13-May-20,Kentucky,Garrison,6151 Kinney Rd,1,4,5
1676515,10-May-20,Louisiana,Baton Rouge,2944 Plank Rd,0,5,5
1676579,10-May-20,Texas,Fort Worth,4750 Wilbarger St,0,5,5
1671078,3-May-20,Illinois,Chicago,3700 W 13th St,0,5,5
1666945,27-Apr-20,Wisconsin,Milwaukee,2800 block of N 12th St,5,0,5
1666600,26-Apr-20,North Carolina,Salisbury,900 block of E Lafayette St,1,4,5
1666327,25-Apr-20,Florida,Orlando,Elese St and Deerock Dr,1,4,5
1661218,17-Apr-20,Massachusetts,Springfield,College St,1,4,5
1653012,5-Apr-20,South Carolina,Lancaster,Mahaffey Line Dr,1,4,5
1652328,4-Apr-20,Florida,Hialeah,W 69th St and 24th Ave,1,4,5
1648832,30-Mar-20,Pennsylvania,Philadelphia,2000 block of W Harold St,0,5,5
1641923,18-Mar-20,Florida,Jacksonville,11501 Harts Rd,1,4,5
1640278,13-Mar-20,Louisiana,New Orleans (Algiers),Wagner St and Hero Blvd,0,5,5
1631040,29-Feb-20,Missouri,Kansas City,510 Westport Rd,1,4,5
1631831,29-Feb-20,Colorado,Brighton,Starr Ln and County Rd 2,0,5,5
1629042,25-Feb-20,Illinois,Chicago,1238 E 79th St,1,4,5
1625553,20-Feb-20,Idaho,Caldwell,4321 S 10th Ave,2,3,5
1622962,16-Feb-20,Florida,Pensacola,517 W Gadsden St,1,4,5
1619064,10-Feb-20,Delaware,Dover,200 block of W Reed St,1,4,5
1611563,31-Jan-20,California,Delano,Hiett Ave and County Line Rd,1,4,5
1605948,26-Jan-20,Missouri,Cape Girardeau,631 S Sprigg St,0,5,5
1606476,24-Jan-20,North Carolina,Vanceboro,107 Kinshaw Ct,5,0,5
1600221,19-Jan-20,Tennessee,Memphis,6761 Winchester Rd,1,4,5
1599331,17-Jan-20,Utah,Grantsville,93 Eastmoor Dr,4,1,5
1598447,16-Jan-20,Illinois,Chicago,234 N Pulaski Rd,0,5,5
1594173,11-Jan-20,Colorado,Aurora,17158 E Adriatic Place,0,5,5
1585894,1-Jan-20,Missouri,Saint Louis,3000 block of S Jefferson Ave,3,2,5
1582816,29-Dec-19,Illinois,Danville,1803 block of Westview Ave,0,5,5
1583444,29-Dec-19,California,Ceres,800 block of Allacante Dr,0,5,5
1580308,26-Dec-19,Florida,Saint Petersburg,4300 6th St S,0,5,5
1594317,24-Dec-19,Illinois,Joliet,1200 block of Cutter Ave,0,5,5
1573754,17-Dec-19,Montana,Great Falls,1701 10th Ave S,4,1,5
1572275,15-Dec-19,Georgia,Columbus,600 block of 32nd St,1,4,5
1567932,8-Dec-19,Texas,Desoto,200 block of W Wintergreen Rd,2,3,5
1567231,8-Dec-19,Louisiana,New Orleans,3801 Washington Ave,1,4,5
1562043,1-Dec-19,Louisiana,Cotton Valley,116 Hawthorne Loop,2,3,5
1561813,1-Dec-19,Illinois,Aurora,700 block of S 5th St,1,4,5
1561398,30-Nov-19,Arkansas,Hensley,6500 block of E Sardis Rd,0,5,5
1559257,27-Nov-19,New York,Bronx,E 153rd St and Courtlandt Ave,0,5,5
1557006,24-Nov-19,Alabama,Birmingham,7 15th St W,1,4,5
1555135,21-Nov-19,California,Long Beach,1100 block of 10th St,0,5,5
1552068,18-Nov-19,New Jersey,Newark,139 S 8th St,1,4,5
1546038,10-Nov-19,Tennessee,Memphis,2080 E. Brooks Rd,1,4,5
1543835,7-Nov-19,Georgia,Conyers,1800 block of Green St,2,3,5
1541774,4-Nov-19,Texas,Houston,5000 block of Northridge Dr,1,4,5
1540240,2-Nov-19,Michigan,Detroit,7000 block of E. Kirby,1,4,5
1539572,1-Nov-19,Arizona,Tolleson,2434 S 86th Ln,0,5,5
1535629,27-Oct-19,Michigan,Lansing,Balfour Dr and W Miller Rd,1,4,5
1530276,19-Oct-19,Texas,El Paso,3812 Truman Ave,1,4,5
1525476,12-Oct-19,Illinois,Chicago,6733 W Irving Park Rd,5,0,5
1524264,10-Oct-19,Pennsylvania,Philadelphia,900 block of S 5th St,0,5,5
1522979,9-Oct-19,Massachusetts,Lowell,149 Ennell Street,0,5,5
1521226,7-Oct-19,Massachusetts,Abington,135 Centre Ave,5,0,5
1520425,6-Oct-19,Indiana,Evansville,1127 Chestnut St,0,5,5
1520547,5-Oct-19,Missouri,Saint Louis,10035 Crown Point Dr,0,5,5
1509721,22-Sep-19,Missouri,Kansas City,2111 Television Plaza,0,5,5
1504012,14-Sep-19,California,Oakland,38th Ave and MacArthur Blvd,1,4,5
1503207,12-Sep-19,New Mexico,Albuquerque,1919 Ladera Dr NW,1,4,5
1495192,2-Sep-19,Alabama,Elkmont,25019 Ridge Road,5,0,5
1493038,31-Aug-19,Illinois,Chicago,7100 block of S Paulina St,2,3,5
1486232,23-Aug-19,Texas,Houston,4900 block of Southwind St,3,2,5
1480326,15-Aug-19,Alabama,Montgomery,847 N University Dr,2,3,5
1479894,15-Aug-19,Pennsylvania,Philadelphia,1400 block of W Conlyn St,0,5,5
1479395,13-Aug-19,Washington,Tacoma,E 38th St and E Roosevelt Ave,2,3,5
1467157,2-Aug-19,Virginia,Suffolk,200 block of N Broad St,2,3,5
1462317,30-Jul-19,Ohio,Columbus,1280 E Long St,0,5,5
1446611,13-Jul-19,Illinois,Chicago,7900 block of S Loomis Blvd,1,4,5
1441613,7-Jul-19,Missouri,Saint Louis,N Tucker Blvd and Convention Plaza,0,5,5
1441721,6-Jul-19,Missouri,Saint Louis,1921 Chambers Rd,5,0,5
1439593,5-Jul-19,Illinois,Chicago,1600 block of E 67th St,0,5,5
1439042,3-Jul-19,Texas,Katy,5507 Everhart Manor Ln,2,3,5
1436545,30-Jun-19,California,Yucaipa,12700 block of California St,0,5,5
1434931,29-Jun-19,Illinois,Chicago,2400 block of W Jackson Blvd,0,5,5
1434602,28-Jun-19,Connecticut,Hamden,937 Choate Ave,0,5,5
1435217,28-Jun-19,Minnesota,Saint Paul,909 Desoto St,0,5,5
1429810,23-Jun-19,California,San Jose,568 Habbitts Court,5,0,5
1429480,23-Jun-19,Ohio,Columbus,1767 Genessee Ave,0,5,5
1428595,22-Jun-19,Maryland,Baltimore,800 block of N Port St,1,4,5
1428047,21-Jun-19,California,Santa Maria,519  West Taylor St,5,0,5
1428229,21-Jun-19,California,Richmond,700 block of 14th St,0,5,5
1425193,18-Jun-19,New Jersey,Newark,700 block of Dr Martin Luther King Jr Blvd,1,4,5
1424957,17-Jun-19,Tennessee,Memphis,2872 Coach Dr,0,5,5
1417716,7-Jun-19,Texas,Austin,8220 TX-71,0,5,5
1412419,1-Jun-19,South Carolina,Allendale,473 Main St S,0,5,5
1411963,1-Jun-19,Georgia,Atlanta,12 Broad Street,0,5,5
1410329,30-May-19,Illinois,Robbins,14000 block of Grace Ave,0,5,5
1408289,29-May-19,Texas,Cleveland,26311 TX-321,3,2,5
1406330,27-May-19,District of Columbia,Washington,1200 block of Sumner Rd SE,0,5,5
1405749,26-May-19,Virginia,La Crosse,800 block of Alvis Road,0,5,5
1404580,25-May-19,Michigan,Detroit,3400 block of Devonshire,3,2,5
1405221,25-May-19,Oklahoma,Oklahoma City,N Kelley Ave and NE 26th St,0,5,5
1400146,20-May-19,Louisiana,Alexandria,1900 block of Bacon Street,1,4,5
1399820,19-May-19,Oregon,Portland,226 SE Madison St,0,5,5
1399017,18-May-19,Mississippi,Cascilla,700 Leverette Ln,1,4,5
1398593,18-May-19,California,Long Beach,1616 West Pacific Coast Highway,1,4,5
1394330,13-May-19,Missouri,Saint Louis,4047 Shreve Ave,4,1,5
1391971,10-May-19,Pennsylvania,Philadelphia,1900 block of N Croskey St,0,5,5
1386962,5-May-19,New Jersey,North Bergen,2033 45th Street,1,4,5
1386510,4-May-19,Missouri,Saint Louis,Union Blvd and Northland Ave,1,4,5
1387245,4-May-19,California,Stockton,5105 Holiday Dr,1,4,5
1386085,3-May-19,Maryland,Baltimore,1900 block of Ramsay St,0,5,5
1369109,11-Apr-19,California,Los Angeles,E 103rd St and S Main St,1,4,5
1369148,11-Apr-19,Arizona,Phoenix,7112 W Minnezona Ave,3,2,5
1362715,4-Apr-19,Georgia,Stockbridge,300 block of Eagle Ct,3,2,5
1362182,2-Apr-19,Kentucky,Covington,337 E 13th St,0,5,5
1360333,31-Mar-19,Georgia,Atlanta,3041 Landrum Dr SW,1,4,5
1359455,31-Mar-19,Illinois,Chicago,500 block of N Hamlin Ave,1,4,5
1355275,25-Mar-19,Nevada,North Las Vegas,2400 block of W San Miguel St,0,5,5
1343274,10-Mar-19,Colorado,Denver,15th St and Market St,1,4,5
1338790,2-Mar-19,Arkansas,Pine Bluff,723 East 25th Ave,1,4,5
1331974,21-Feb-19,Maryland,Baltimore,500 block of Bloom St,1,4,5
1328792,17-Feb-19,Indiana,Evansville,664 E Illinois St,0,5,5
1328562,16-Feb-19,Mississippi,Clinton,1214 Foxhill Dr,5,0,5
1324279,11-Feb-19,Texas,Livingston,3628 FM 3126,5,0,5
1319333,4-Feb-19,District of Columbia,Washington,2341 Pennsylvania Ave SE,0,5,5
1314253,27-Jan-19,Alabama,Birmingham,Avenue O and Warrior Rd,0,5,5
1312284,26-Jan-19,Louisiana,Gonzales,42350 Church Point Rd,5,0,5
1312463,26-Jan-19,Indiana,Indianapolis,2957 N Sherman Dr,0,5,5
1310775,24-Jan-19,Pennsylvania,State College,1450 S Atherton St,4,1,5
1310397,24-Jan-19,Georgia,Rockmart,319 Williamson St,4,1,5
1309114,23-Jan-19,Florida,Sebring,1901 US 27 S,5,0,5
1305679,19-Jan-19,South Carolina,Gaffney,1435 Wilcox Ave,1,4,5
1305538,19-Jan-19,Florida,Jacksonville,11445 Brian Lakes Drive,3,2,5
1305294,19-Jan-19,Texas,Houston,7041 Sherman St,3,2,5
1301778,15-Jan-19,Arkansas,Little Rock,5420 Baseline Rd,1,4,5
1292684,4-Jan-19,Virginia,Hurt,3197 Shula Dr,3,2,5
1289877,1-Jan-19,South Carolina,Columbia,1709 Decker Blvd,0,5,5
1289618,1-Jan-19,Florida,Tallahassee,2020 W Pensacola St,0,5,5
1289686,31-Dec-18,Ohio,Cleveland,4462 Denison Ave,3,2,5
1287286,28-Dec-18,Missouri,Saint Charles,150 Whetstone Dr,4,1,5
1279617,18-Dec-18,Maryland,Baltimore,3942 Park Heights Ave,0,5,5
1277327,15-Dec-18,Florida,Miami,239 NW 16th St,0,5,5
1273161,8-Dec-18,California,Inglewood,801 S Inglewood Ave,0,5,5
1272106,8-Dec-18,New York,Corona (Queens),89-25 130th St,0,5,5
1267682,1-Dec-18,Florida,Miami,NW Fifth Ave and NW Eighth St,0,5,5
1261351,22-Nov-18,Indiana,Fort Wayne,6100 block of Downingtown Dr,3,2,5
1258777,19-Nov-18,Colorado,Denver,1200 21st Street,1,4,5
1258009,18-Nov-18,California,Los Angeles (Watts),95th St and Defiance Ave,1,4,5
1254225,13-Nov-18,New Mexico,Gallup,CR 1 and Defiance Draw Rd,4,1,5
1246727,3-Nov-18,New York,Watertown,136 Franklin St,0,5,5
1245703,1-Nov-18,Minnesota,Minneapolis,3400 block of Girard Ave N,0,5,5
1245274,1-Nov-18,Missouri,Springfield,906 E Locust St,3,2,5
1246059,30-Oct-18,California,Vallejo,Woodrow Ave and Reis Ave,2,3,5
1244424,30-Oct-18,California,Los Angeles,65th Place and Vermont Avenue,0,5,5
1242807,27-Oct-18,Tennessee,Memphis,4275 Lady Slipper Ln,0,5,5
1240751,24-Oct-18,Illinois,Chicago,6200 block of S King Dr,0,5,5
1233663,15-Oct-18,Tennessee,Columbia,1075 Carters Creek Pike,5,0,5
1232288,13-Oct-18,Texas,Taft,511 Wilburn St,4,1,5
1223755,3-Oct-18,Pennsylvania,Philadelphia,5101 Germantown Ave,1,4,5
1220912,29-Sep-18,Florida,Orlando,1700 block of 24th St,1,4,5
1217150,24-Sep-18,Tennessee,Memphis,1528 Ragan St,3,2,5
1215987,23-Sep-18,California,Bakersfield,2600 block of Chandler Court,1,4,5
1214298,20-Sep-18,New York,Syracuse,1317 Midland Ave,0,5,5
1213223,19-Sep-18,Wisconsin,Middleton,1850 Deming Way,1,4,5
1213293,19-Sep-18,Pennsylvania,Masontown,1 E Church St,1,4,5
1211659,17-Sep-18,Maryland,Silver Spring,123 Amberleigh Dr,4,1,5
1206828,10-Sep-18,Tennessee,Memphis,140 Lt George W Lee Ave,0,5,5
1206375,9-Sep-18,Alabama,Auburn,224 W Magnolia St,1,4,5
1200904,31-Aug-18,Colorado,Aurora,1900 block of Peoria St,2,3,5
1195537,25-Aug-18,Virginia,Richmond,4 N 18th St,0,5,5
1196051,25-Aug-18,Tennessee,Nashville,1564 9th Ave N,1,4,5
1191368,20-Aug-18,Tennessee,Jackson,60 Heritage Square,1,4,5
1191279,19-Aug-18,Illinois,Chicago,7400 block of S Dante Ave,0,5,5
1188597,15-Aug-18,South Carolina,Greenwood,104 Mimosa Ct,0,5,5
1186888,14-Aug-18,Pennsylvania,Wyncote,1000 S Easton Rd,0,5,5
1185520,12-Aug-18,California,Clearlake,4786 Yarrington Ct,4,1,5
1186061,11-Aug-18,California,San Francisco,Geneva St and Mission St,1,4,5
1179935,5-Aug-18,Illinois,Chicago,50 block of N Leclaire Ave,1,4,5
1176169,31-Jul-18,California,Gardena,1212 West 135th Street,2,3,5
1174960,29-Jul-18,Arizona,Phoenix,2501 E Van Buren St,1,4,5
1173476,27-Jul-18,Texas,Robstown,603 East Ave J,5,0,5
1170482,23-Jul-18,Illinois,Chicago,6400 block of S May St,0,5,5
1169656,20-Jul-18,Washington,Sunnyside,500 block of S 15th St,1,4,5
1165183,16-Jul-18,District of Columbia,Washington,300 block of 53rd St NE,1,4,5
1165299,16-Jul-18,Pennsylvania,Philadelphia,2100 block of N 4th St,1,4,5
1164110,15-Jul-18,Tennessee,Chattanooga,1400 Cowart St,0,5,5
1162687,12-Jul-18,Tennessee,Memphis,3678 Powers Rd,0,5,5
1159820,9-Jul-18,Florida,Orlando,Southland Blvd and Orange Blossom Trail,1,4,5
1160253,9-Jul-18,Delaware,Wilmington,2709 Ferris Rd,5,0,5
1158826,7-Jul-18,Alabama,Wetumpka,135 Granite Way,3,2,5
1153471,30-Jun-18,New Jersey,Jersey City,Lexington Ave and John F Kennedy Blvd,0,5,5
1151584,28-Jun-18,Maryland,Annapolis,888 Bestgate Rd,5,0,5
1148596,24-Jun-18,Ohio,Sandusky,1504 Milan Rd,0,5,5
1147720,23-Jun-18,Illinois,Chicago,100 block of East 51st St,1,4,5
1145709,20-Jun-18,California,Modesto,2300 block of West Hatch Road,0,5,5
1143558,18-Jun-18,Illinois,Chicago,1300 block of S Loomis St,2,3,5
1141645,14-Jun-18,California,Union City,32992 Mission Blvd,0,5,5
1141745,14-Jun-18,New York,Buffalo,Marigold Ave,1,4,5
1141943,14-Jun-18,California,Tracy,West 6th Street,1,4,5
1137586,10-Jun-18,Indiana,Indianapolis (Lawrence),4745 N Richardt Ave,1,4,5
1137402,9-Jun-18,Pennsylvania,Philadelphia,2000 block of 20th St,1,4,5
1132408,3-Jun-18,Texas,Dallas,4500 Spring Ave,0,5,5
1132050,2-Jun-18,New York,Buffalo,Strauss Street,0,5,5
1129432,31-May-18,South Carolina,Timmonsville,544 Chaney Grove Rd,3,2,5
1115051,13-May-18,California,Stockton,2436 Belleview St,3,2,5
1112948,11-May-18,Oklahoma,Talihina,2nd St and Dallas St,1,4,5
1110399,7-May-18,California,San Diego,15th St and J St,0,5,5
1108879,5-May-18,Georgia,Columbus,4944 Sentry Street,0,5,5
1106451,2-May-18,Illinois,Chicago,3500 block of W Grenshaw St,1,4,5
1106557,2-May-18,Minnesota,Minneapolis,2400 block of Ogema Place,0,5,5
1106432,2-May-18,New York,Brooklyn,333 Bristol St,1,4,5
1105061,1-May-18,Louisiana,New Orleans,3200 block of Saint Claude Ave,0,5,5
1102559,28-Apr-18,North Carolina,Maxton,Modest Rd,0,5,5
1082835,1-Apr-18,Michigan,Saginaw,600 block of Yale St,0,5,5
1083011,1-Apr-18,Alabama,Mobile,3556 Halls Mill Rd,1,4,5
1082273,31-Mar-18,New Jersey,Asbury Park,Atlantic Ave and Monmouth Ave,0,5,5
1067296,11-Mar-18,Michigan,Saginaw,Cumberland Ave and Hess St,1,4,5
1062466,4-Mar-18,Illinois,Rockford,426 Howard Ave,1,4,5
1057518,26-Feb-18,Michigan,Detroit,22700 Fenkell Ave,5,0,5
1052372,18-Feb-18,Texas,San Antonio,2893 Cinema Ridge,0,5,5
1051407,17-Feb-18,Tennessee,Memphis,3188 N Watkins Ave,0,5,5
1049024,13-Feb-18,Louisiana,New Orleans,5400 block of Andry St,2,3,5
1046961,10-Feb-18,Kentucky,Paintsville,413 Mill St,5,0,5
1037529,28-Jan-18,Pennsylvania,Melcroft,1301 Indian Creek Valley Rd,5,0,5
1037515,28-Jan-18,Indiana,Indianapolis,1313 N Sherman Dr,2,3,5
1037541,27-Jan-18,California,Los Angeles,243 East 119th St,0,5,5
1042072,15-Jan-18,Florida,Alachua,14223 NW 156th Pl,0,5,5
1026804,14-Jan-18,Alabama,Eutaw,809 Mesopotamia St,1,4,5
1025673,12-Jan-18,Tennessee,Nashville,2614 Jenkins Ct,3,2,5
1015336,26-Dec-17,Florida,Miami,NW 18th Ave and 86th Ter,0,5,5
1013983,24-Dec-17,Mississippi,Vicksburg,1111 Mulberry Street,0,5,5
1014052,24-Dec-17,Alabama,Troy,100 block of Chapman St,1,4,5
1008310,15-Dec-17,California,Pacoima,13041 Jouett Street,0,5,5
998843,30-Nov-17,Michigan,Detroit,11000 block of Gunston,1,4,5
987134,12-Nov-17,California,Fresno,S Calvin Ave,0,5,5
980401,3-Nov-17,Louisiana,Lacombe,27600 block of Mirmar Street,1,4,5
966895,23-Oct-17,California,Clearlake Oaks,13000 block of Anchor Village,2,3,5
955268,9-Oct-17,Texas,Houston,3352 Old Spanish Trail,0,5,5
953156,6-Oct-17,Illinois,Chicago,8000 block of S Marshfield,0,5,5
945990,1-Oct-17,Kansas,Lawrence,1000 block of Massachusetts St,3,2,5
939834,23-Sep-17,California,Bakersfield,818 Real Rd,1,4,5
940068,23-Sep-17,Illinois,Danville,Seminary St and Jackson St,0,5,5
939482,20-Sep-17,Indiana,Gary,4300 block of 23rd Ct,0,5,5
935928,17-Sep-17,Virginia,Petersburg,300 Mistletoe St,1,4,5
926766,3-Sep-17,California,Inglewood,10100 block of S Firmona Ave,2,3,5
921733,27-Aug-17,California,Sacramento,7760 24th St,1,4,5
916551,19-Aug-17,Ohio,Cleveland,11143 Superior Ave,1,4,5
912805,13-Aug-17,Pennsylvania,Philadelphia,39th St and Melon St,0,5,5
906509,4-Aug-17,Montana,Lodge Grass,200 block of North Helen Street,3,2,5
901083,29-Jul-17,New York,Buffalo,200 block of Carl St,1,4,5
901000,29-Jul-17,North Carolina,Salisbury,115 W Fisher St,2,3,5
900387,27-Jul-17,Illinois,Chicago,2000 block of E 71st St,1,4,5
896149,22-Jul-17,Ohio,Cincinnati,130 E Clifton Ave,0,5,5
893690,19-Jul-17,Virginia,Richmond,2300 block of Bethel St,0,5,5
883058,5-Jul-17,Maine,Madison,300 block of Russell Rd,4,1,5
882321,4-Jul-17,Virginia,Hampton,500 block of Patterson Ave,1,4,5
877295,27-Jun-17,Illinois,Chicago,200 block of S Lotus,0,5,5
874613,24-Jun-17,Florida,Fort Lauderdale,2335 NW 16th Ct,1,4,5
875322,24-Jun-17,New York,New York (Manhattan),114th St and Manhattan Ave,0,5,5
870095,18-Jun-17,Missouri,Saint Louis,1900 block of N 14th St,3,2,5
869357,17-Jun-17,Ohio,Columbus,6252 Busch Blvd,1,4,5
868363,15-Jun-17,New Mexico,La Madera,491 NM-111,5,0,5
861307,6-Jun-17,Utah,Sandy,2232 Alta Canyon Drive,3,2,5
858719,3-Jun-17,Louisiana,New Orleans,3717 Tulane Ave,3,2,5
858378,2-Jun-17,Texas,Laredo,5301 McPherson Rd,2,3,5
853920,28-May-17,Mississippi,Moss Point,6103 Hwy. 63,0,5,5
843045,14-May-17,Illinois,Dolton,14112 Chicago Road,0,5,5
843172,14-May-17,Florida,Avon Park,Hal McRae Blvd and Delaney Ave,0,5,5
833152,1-May-17,Texas,Dallas,3200 block of Reynolds Ave,2,3,5
832528,30-Apr-17,Kansas,Topeka,4104 SW 28th,4,1,5
833128,30-Apr-17,Florida,Jacksonville,1200 Ken Knight Dr N,0,5,5
832290,29-Apr-17,California,Sacramento,3800 block of 26th Avenue,0,5,5
813821,7-Apr-17,Texas,Houston,3829 Mount Pleasant St,5,0,5
813943,7-Apr-17,Minnesota,Saint Paul,1600 block of English St,4,1,5
809683,2-Apr-17,Iowa,Des Moines,2500 Martin Luther King Jr. Parkway,0,5,5
809815,1-Apr-17,California,Pittsburg,100 block of Madoline Street,0,5,5
809048,1-Apr-17,Florida,Tampa,219 S Howard Ave,1,4,5
809499,1-Apr-17,Oklahoma,Oklahoma City,1200 block of N Woodward Avenue,2,3,5
802926,25-Mar-17,Tennessee,Knoxville,Minnesota Ave,1,4,5
802425,24-Mar-17,California,Fresno,300 block of South Villa Avenue,1,4,5
800363,22-Mar-17,Wisconsin,Rothschild,1133 E Grand Ave,5,0,5
797125,18-Mar-17,Michigan,Detroit,16000 block of Rutherford,3,2,5
787875,4-Mar-17,Kansas,Topeka,SE Bellview Ave and SE 23rd St,1,4,5
787435,3-Mar-17,California,Riverside,8300 block of Trey Ave,0,5,5
783623,26-Feb-17,Indiana,Gary,1700 Grant St,1,4,5
783102,25-Feb-17,Ohio,Warren,1564 Niles Cortland Rd SE,2,3,5
783090,25-Feb-17,Florida,Jacksonville,3604 Moncrief Rd,1,4,5
778941,20-Feb-17,Ohio,Cleveland,1082 East 105th Street,0,5,5
775531,15-Feb-17,Illinois,Chicago,3949 South Albany Avenue,3,2,5
773908,12-Feb-17,Florida,Greenville,Church Ave and Obadiah St,0,5,5
769889,8-Feb-17,Ohio,Cleveland,16379 Euclid Ave,1,4,5
769859,7-Feb-17,Arkansas,Little Rock,25 Par Drive,1,4,5
763313,29-Jan-17,Louisiana,Shreveport,6363 Hearne Ave,1,4,5
760482,26-Jan-17,Georgia,Albany,1510 Maryland Drive,2,3,5
757158,22-Jan-17,Texas,Manvel,200 block of Oak Shore Dr,3,2,5
756526,21-Jan-17,Florida,Boynton Beach,500 NE 2nd St,0,5,5
757955,20-Jan-17,Mississippi,Como,Smart Road,1,4,5
751367,15-Jan-17,Mississippi,Magnolia,6000 block of Church Road,1,4,5
749361,12-Jan-17,Missouri,Kansas City,8607 E 61st Terrace,3,2,5
743282,1-Jan-17,Mississippi,Winstonville,114 North Greyer Street,0,5,5
738041,30-Dec-16,Ohio,Mansfield,3230 Possum Run Rd,0,5,5
738576,30-Dec-16,Connecticut,Wallingford,95 S Turnpike Rd,2,3,5
736690,28-Dec-16,Georgia,Columbus,2914 10th Street,1,4,5
727759,17-Dec-16,Illinois,Chicago (Roseland),100 block of W 105th St,5,0,5
723643,11-Dec-16,Florida,Orlando (Pine Hills),4305 N Pine Hills Rd,1,4,5
723292,11-Dec-16,Maryland,Baltimore,3916 South Hanover Street,0,5,5
719128,5-Dec-16,New Mexico,Albuquerque,1532 Stagecoach Lane,4,1,5
708392,22-Nov-16,Florida,Clewiston,1068 Harlem Academy Ave,1,4,5
699605,13-Nov-16,Florida,Jacksonville,5105 Cleveland Rd,3,2,5
700232,13-Nov-16,California,San Diego,3800 block of Marlborough Avenue,3,2,5
699303,12-Nov-16,Connecticut,Bridgeport,2500 Park Avenue,0,5,5
696917,9-Nov-16,Washington,Seattle,1524 3rd Ave,0,5,5
693401,5-Nov-16,South Carolina,Myrtle Beach,803 Main St,0,5,5
693290,5-Nov-16,Illinois,Chicago,4800 block of North Winthrop,0,5,5
692025,2-Nov-16,Arkansas,Little Rock,2111 Bragg Street,1,4,5
688592,30-Oct-16,Texas,San Antonio,2900 block of Aspen Meadow,0,5,5
689009,29-Oct-16,California,Los Angeles,1600 block of Century Boulevard,0,5,5
684130,25-Oct-16,Virginia,Roanoke,830 Campbell Avenue Southeast,2,3,5
678438,17-Oct-16,Illinois,Chicago (Englewood),6700 block of South Winchester,1,4,5
677293,15-Oct-16,Alabama,Mobile,1800 block of St Stephens Road,0,5,5
669777,4-Oct-16,Louisiana,New Orleans,3727 Ulloa Street,3,2,5
667984,2-Oct-16,Texas,San Antonio,2600 South Flores Street,1,4,5
661703,23-Sep-16,Washington,Burlington,201 Cascade Mall Dr,5,0,5
654087,13-Sep-16,Indiana,Fort Wayne,1723 E Wayne St,3,2,5
652561,11-Sep-16,Michigan,Saginaw,2207 Pierce Road,0,5,5
652606,11-Sep-16,North Carolina,New Bern,1100 block of Highway 70,0,5,5
651434,8-Sep-16,Arkansas,Hot Springs National Park (Hot Springs),300 block of Lacey St,1,4,5
648884,5-Sep-16,Illinois,Chicago,2700 block of W Lexington Ave,2,3,5
640861,28-Aug-16,Alabama,Dadeville,512 E Columbus St,0,5,5
640901,25-Aug-16,New Jersey,Bridgeton,Marion Street,0,5,5
634731,20-Aug-16,Washington,Tacoma,900 block of Pacific Avenue,0,5,5
634819,20-Aug-16,Alabama,Citronelle,Jim Platt Road,5,0,5
629415,14-Aug-16,Minnesota,Minneapolis,1717 Plymouth Ave N,0,5,5
623195,6-Aug-16,Pennsylvania,Reading (Sinking Spring),51 Winding Brook Drive,5,0,5
617607,31-Jul-16,Texas,Austin,208 E 6th St,1,4,5
617712,30-Jul-16,Missouri,Saint Louis,5000 block of Kensington Ave,0,5,5
618321,30-Jul-16,Georgia,Townsend (Eulonia),14699 Highway 17,0,5,5
615109,28-Jul-16,New York,Elmira,303 College Ave,0,5,5
610379,23-Jul-16,Texas,Bastrop,202 Childers Drive,4,1,5
610402,22-Jul-16,Illinois,Kankakee,300 block of North Wildwood Avenue,0,5,5
609402,21-Jul-16,Illinois,Chicago,4400 block of South Leamington,0,5,5
604459,16-Jul-16,Texas,Dallas,6300 block of Benavides Drive,0,5,5
604275,16-Jul-16,Ohio,Cleveland,5000 block of Euclid Avenue,0,5,5
602810,13-Jul-16,Georgia,Warner Robins,105 Magnolia Avenue,0,5,5
600798,11-Jul-16,Maryland,Baltimore,1800 block of W. North Avenue,0,5,5
600398,11-Jul-16,Michigan,Saint Joseph,811 Port St,3,2,5
597176,7-Jul-16,Tennessee,Bristol,536 Volunteer Pkwy,1,4,5
595069,4-Jul-16,Texas,Houston,1312 Robin,3,2,5
594051,3-Jul-16,Louisiana,Monroe,401 Lea Joyner Memorial Expy,2,3,5
592724,30-Jun-16,Illinois,Chicago,9500 block of South Loomis Street,1,4,5
592207,29-Jun-16,Nevada,Las Vegas,6100 block of West Lake Mead Boulevard,5,0,5
589159,26-Jun-16,North Carolina,Charlotte,2240 Camp Greene St,0,5,5
588867,26-Jun-16,Georgia,Atlanta,1500 block of Moreland Avenue SE,1,4,5
587735,24-Jun-16,Connecticut,Hartford,Brook and Winter Street,0,5,5
587769,24-Jun-16,Maryland,District Heights,3100 block of Orleans Ave,3,2,5
579786,13-Jun-16,New York,Brooklyn,Avenue D and E. 57th,0,5,5
580279,13-Jun-16,Illinois,Chicago,3200 block of West Congress,0,5,5
577574,11-Jun-16,New Mexico,Roswell,2300 block of Davis Ave,5,0,5
577073,11-Jun-16,California,Panorama City,8500 block of Cedros Avenue,3,2,5
568528,30-May-16,Maryland,Baltimore,500 block of East 43rd Street,0,5,5
568745,30-May-16,California,Sacramento,3900 block of 44th,0,5,5
564470,23-May-16,New Jersey,Newark,102 Isabella Avenue,0,5,5
565244,15-May-16,Georgia,Moultrie,Rossman Dairy Road,5,0,5
559042,14-May-16,Georgia,Atlanta,Cordova and Peoples Street,0,5,5
557589,11-May-16,Alabama,Birmingham,1400 block of 21st St N,1,4,5
557479,11-May-16,Illinois,Chicago,7100 block of South State Street,0,5,5
555873,6-May-16,Michigan,Detroit,12300 block of Gratiot,1,4,5
551053,1-May-16,Tennessee,Murfreesboro,1955 Old Castle Drive,0,5,5
550619,29-Apr-16,California,Oakland,3200 block of San Pablo Avenue,0,5,5
548333,26-Apr-16,Maryland,District Heights (Forestville),6500 block of Hil-Mar Drive,1,4,5
547827,25-Apr-16,Florida,Miami,1506 Northwest 70th Street,0,5,5
546760,24-Apr-16,Virginia,Halifax,1055 L P Bailey Memorial Hwy,0,5,5
547319,24-Apr-16,Illinois,Chicago (Englewood),2000 block of West 68th Place,2,3,5
546550,23-Apr-16,Kansas,Topeka,3732 SW Topeka Blvd,1,4,5
543441,19-Apr-16,Alabama,Blountsville,81551 US Highway 278,1,4,5
543132,19-Apr-16,Illinois,Chicago,1400 block of West 84th Street,1,4,5
542259,16-Apr-16,Michigan,Detroit,9500 block of Oakland,1,4,5
525464,19-Mar-16,Florida,Plantation,12050 NW 4th Court,1,4,5
523044,15-Mar-16,Georgia,Atlanta,Donald Lee Hollowell Drive,0,5,5
520290,11-Mar-16,New Jersey,Trenton,Oliver Avenue,0,5,5
518266,8-Mar-16,Texas,San Antonio,Sherman St,2,3,5
518436,7-Mar-16,Kansas,Kansas City,3000 block of South 36th Street,5,0,5
513549,28-Feb-16,Michigan,Detroit,8800 block of Livernois,0,5,5
512073,26-Feb-16,Washington,Belfair,300 block of Horseshoe Rd,5,0,5
509897,23-Feb-16,Arizona,Glendale,4812 West Sunnyside Ave,5,0,5
509707,21-Feb-16,Texas,Houston,5100 block of Idaho Street,0,5,5
508113,20-Feb-16,Mississippi,Iuka,231 Co Rd 201,2,3,5
505420,14-Feb-16,Alabama,Eutaw (Union),Earnest Friday Road,0,5,5
493536,26-Jan-16,Washington,Seattle,Airport Way S. and S. Atlantic St.,2,3,5
493085,25-Jan-16,California,Perris,140 S. D Street,1,4,5
483750,11-Jan-16,Delaware,Wilmington,900 block of Brown Street,1,4,5
481900,8-Jan-16,Illinois,Chicago,1500 block of South Kedzie,1,4,5
468968,20-Dec-15,North Carolina,Wilmington,11th and Castle Street,1,4,5
468787,19-Dec-15,Florida,Miami,21630 SW 120th Ave,1,4,5
460386,6-Dec-15,Nebraska,Omaha,North 108th Street and Military Road,2,3,5
455394,29-Nov-15,Illinois,Kankakee,648 E Court St,0,5,5
452120,23-Nov-15,Minnesota,Minneapolis,Morgan Avenue North,0,5,5
452007,23-Nov-15,Ohio,Columbus,90 block of S Terrace Ave,4,1,5
451305,22-Nov-15,New York,Newburgh,203 Broadway,0,5,5
449814,18-Nov-15,California,Fresno,California Avenue and Martin Luther King Jr. Boulevard,0,5,5
448419,15-Nov-15,Texas,Tennessee Colony,800 block of An County Rd 2217,5,0,5
446996,13-Nov-15,Florida,Jacksonville,1300 block of South Shirley Oaks Drive,4,1,5
441681,3-Nov-15,Florida,Jacksonville,Ella Street and Kings Road,2,3,5
437836,27-Oct-15,Texas,Fort Worth,1700 block of Southcrest Drive,0,5,5
437323,26-Oct-15,Indiana,Evansville,711 E Virginia St,0,5,5
436234,25-Oct-15,Arizona,Phoenix,Seventh Street and Broadway,1,4,5
436240,25-Oct-15,District of Columbia,Washington,4300 block of Wheeler Road SE,0,5,5
436202,25-Oct-15,North Carolina,Four Oaks,2339 Stricklands Crossroads Road,0,5,5
432466,17-Oct-15,Florida,Fort Myers,2224 First St,1,4,5
426256,6-Oct-15,Maryland,Baltimore,300 block of North Payson Street,0,5,5
424224,2-Oct-15,Maryland,Baltimore,5400 Reisterstown Road,1,4,5
422064,28-Sep-15,Illinois,Chicago,300 block of West 42nd Street,3,2,5
422035,28-Sep-15,Illinois,Chicago,5300 block of South Aberdeen Street,2,3,5
421650,28-Sep-15,Ohio,Cincinnati,1800 block of Hewitt Ave,0,5,5
419718,24-Sep-15,Illinois,Chicago,5100 block of South Morgan Street,0,5,5
419250,23-Sep-15,Louisiana,Shreveport,2900 block of Peach Street,0,5,5
412557,11-Sep-15,North Carolina,Charlotte,1000 North Carolina Music Factory Blvd.,0,5,5
412040,7-Sep-15,Minnesota,Excelsior,Channel Drive,5,0,5
404167,30-Aug-15,Tennessee,Memphis,3300 block of Sobota Circle,1,4,5
404238,29-Aug-15,Tennessee,Bristol,618 Henson Road,3,2,5
395718,16-Aug-15,South Carolina,Bennettsville,Highway 38N,0,5,5
390914,8-Aug-15,North Carolina,Gastonia,4908 Greenwood Dr,2,3,5
389149,4-Aug-15,Missouri,Saint Louis,2500 block of Semple,1,4,5
387194,3-Aug-15,New York,Brooklyn,98 Dwight Street,0,5,5
385824,2-Aug-15,Illinois,Chicago,4800 block of West Kamerling Avenue,1,4,5
386066,2-Aug-15,Georgia,Savannah,Barnard Street,0,5,5
382459,27-Jul-15,Illinois,Rockford,900 block of Kent Street,0,5,5
381814,26-Jul-15,Missouri,Kansas City,Thompson and Colorado,2,3,5
379166,22-Jul-15,Georgia,Suwanee,5500 block of Old Atlanta Road,5,0,5
390936,18-Jul-15,California,Santa Paula,Ojai-Santa Paula St,0,5,5
376702,18-Jul-15,Oregon,Salem,1550 Weston Ct NE,1,4,5
376211,17-Jul-15,Illinois,Chicago,4400 block of W. Maypole,0,5,5
375773,16-Jul-15,Texas,Dallas,2261 Singleton Blvd,0,5,5
374602,15-Jul-15,Georgia,Atlanta,500 block of Center Hill Avenue,0,5,5
374630,15-Jul-15,South Carolina,Holly Hill,7050 Old State Road,4,1,5
373768,13-Jul-15,California,Stockton,400 block of McCloud Avenue,1,4,5
373095,12-Jul-15,Illinois,River Forest,116 Lathrop Ave,2,3,5
368987,4-Jul-15,Massachusetts,Pittsfield,Dewey Avenue,1,4,5
365391,28-Jun-15,Michigan,Detroit,Gratiot and Loretto,0,5,5
361708,21-Jun-15,Kentucky,Lexington,726 Georgetown St,1,4,5
357732,13-Jun-15,Georgia,Fayetteville,600 block of Highway 279,1,4,5
357701,13-Jun-15,New York,Bronx,2409 Creston Avenue,0,5,5
357164,13-Jun-15,Ohio,Columbus,1623 E. Hudson Street,4,1,5
353854,7-Jun-15,Montana,Deer Lodge,Boulder Creek Road,5,0,5
353536,6-Jun-15,New York,Buffalo,100 block of Warren Avenue,1,4,5
353037,6-Jun-15,Illinois,Chicago,100 block of North Lorel Avenue,0,5,5
353382,5-Jun-15,Iowa,Davenport,900 block of West 3rd St,0,5,5
350182,31-May-15,Georgia,Conyers,4669 Bell Road SE,3,2,5
349976,31-May-15,Connecticut,New Haven,849 Chapel Street,0,5,5
348620,28-May-15,Illinois,Chicago,6200 block of South Honore Street,0,5,5
346097,25-May-15,Illinois,Decatur,1816 N Water,1,4,5
345681,24-May-15,Massachusetts,Brockton,1002 Main St,0,5,5
342589,18-May-15,Florida,Miami,Northwest 75th Street and Northwest 16th Avenue,1,4,5
341465,16-May-15,Wisconsin,Milwaukee,28th Street and Auer Avenue,0,5,5
341232,16-May-15,Maryland,Baltimore,1700 block of North Broadway,0,5,5
339229,12-May-15,Arizona,Tucson,800 block of West Calle Medina Road,5,0,5
340280,12-May-15,Maryland,Capitol Heights,4700 block of Pard Rd,1,4,5
337855,10-May-15,Ohio,Cleveland,3600 block of Bosworth Rd,1,4,5
333750,3-May-15,Wisconsin,Menasha,Friendship Trail,4,1,5
332732,1-May-15,Wisconsin,Milwaukee,3700 block of 37th Street,2,3,5
326792,21-Apr-15,Texas,Killeen,420 Gilmer St,2,3,5
327341,18-Apr-15,Alabama,Montgomery,1800 block of Gibbs Court,0,5,5
325445,18-Apr-15,Pennsylvania,Williamsport,321 Pine St,0,5,5
324424,16-Apr-15,Arizona,Phoenix,4300 block of East Anderson Drive,5,0,5
318221,5-Apr-15,Kentucky,Louisville,40th and Grand Street,1,4,5
318297,5-Apr-15,Indiana,Indianapolis,5000 block of Wildflower Court,0,5,5
316795,2-Apr-15,Maryland,Baltimore,1900 block of West Lanvale Street,0,5,5
311922,23-Mar-15,Tennessee,Clarksville,900 block of Carpenter Street,1,4,5
306897,14-Mar-15,Georgia,Atlanta,2900 block of Delmar Lane,0,5,5
305907,13-Mar-15,Mississippi,Brookhaven,1097 South First St.,2,3,5
304238,10-Mar-15,Georgia,Columbus,3023 Victory Drive,0,5,5
296215,22-Feb-15,Texas,Killeen,1706 Godman St.,4,1,5
296121,22-Feb-15,Georgia,Clarkesville,281 Lower Pond Court,3,2,5
293883,15-Feb-15,California,Long Beach,200 block of W. 14th Street,0,5,5
290098,6-Feb-15,Oklahoma,Tulsa,1219 N. Sheridan Road,1,4,5
287031,1-Feb-15,New York,New York (Manhattan),3345 Broadway,1,4,5
282956,24-Jan-15,New York,Arverne (Queens),231-11 148th Avenue,4,1,5
298773,13-Jan-15,Virginia,Portsmouth,4100 block of Portsmouth Boulevard,0,5,5
276766,11-Jan-15,California,San Jose,3840 Monterey Hwy,0,5,5
273965,2-Jan-15,Georgia,Savannah,500 block of W. 54th Street,1,4,5
272016,1-Jan-15,Tennessee,Memphis,I-240 and Poplar Ave,0,5,5
267721,22-Dec-14,Illinois,Chicago,5700 block of South Green Street,0,5,5
268910,21-Dec-14,Mississippi,Waynesboro,Central Avenue,1,4,5
263376,14-Dec-14,Florida,Miami,1311 Northwest 2nd Avenue,1,4,5
263382,13-Dec-14,Florida,Tampa,810 E. Skagway Ave.,0,5,5
226983,2-Dec-14,Virginia,Newport News,6128 Jefferson Ave ,0,5,5
226534,30-Nov-14,Tennessee,Chattanooga,2412 East 13th Street ,0,5,5
225903,29-Nov-14,Georgia,Atlanta,1600 block of Richmond Avenue,3,2,5
226018,27-Nov-14,Texas,Georgetown,Pvt Rd 934,2,3,5
224131,23-Nov-14,Colorado,Denver,Federal Boulevard and 16th Avenue,1,4,5
223651,22-Nov-14,Ohio,Cleveland,1443 E 92nd St,4,1,5
223799,22-Nov-14,South Dakota,Sisseton,Fourth Avenue,4,1,5
221554,16-Nov-14,Ohio,Akron,1891 E Market St,1,4,5
217831,8-Nov-14,California,Pomona,499 E. Arrow Highway,0,5,5
212884,29-Oct-14,Tennessee,Memphis,Yale Road and Ramill Road,0,5,5
205726,14-Oct-14,Georgia,Peachtree Corners,6505 Bannor Lane,3,2,5
204236,11-Oct-14,New York,Utica,222 Bleecker Street,0,5,5
197287,27-Sep-14,Missouri,Saint Louis,2000 block East John Avenue,0,5,5
198064,26-Sep-14,South Carolina,Florence,650 Turner Rd,1,4,5
191416,15-Sep-14,Louisiana,New Orleans,Chef Menteur Highway and Dale Street,0,5,5
186488,6-Sep-14,Georgia,Macon,576 Poplar Street,0,5,5
185393,4-Sep-14,Michigan,Flint,2400 block of Martin Luther King Boulevard,0,5,5
185196,2-Sep-14,Mississippi,Jackson,3622 Medgar Evers Boulevard,2,3,5
184507,2-Sep-14,California,Highland,25000 block of Fifth Street ,0,5,5
183432,31-Aug-14,California,Livermore,200 block of South Q Street ,0,5,5
178425,20-Aug-14,Tennessee,Memphis,1400 block of Briarcrest Lane,0,5,5
173628,12-Aug-14,Georgia,Cartersville,Brent Cir,2,3,5
169326,4-Aug-14,Georgia,Atlanta,1100 block of Joseph E. Boone Boulevard NW,0,5,5
168844,3-Aug-14,Virginia,Culpeper,14458 Rixeyville Rd,5,0,5
168786,3-Aug-14,Missouri,Saint Louis,5200 block of Thekla ,0,5,5
169024,3-Aug-14,Tennessee,Columbia,East 9th Street and Bridge Street,0,5,5
165856,28-Jul-14,Pennsylvania,Philadelphia,4900 block of North Front Street,1,4,5
165089,27-Jul-14,Missouri,Saint Louis,2000 block of East John Avenue,0,5,5
164513,26-Jul-14,Maine,Saco,35 Water Street,5,0,5
158387,14-Jul-14,California,Sacramento,Fulton Avenue ,1,4,5
158306,13-Jul-14,Washington,Skyway,12600 Renton Avenue South ,0,5,5
158589,13-Jul-14,Connecticut,Stamford,84 West Park Place,0,5,5
157857,12-Jul-14,California,Pasadena,1700 block of Summit Avenue,3,2,5
156468,8-Jul-14,Rhode Island,Providence,35 March Street,0,5,5
155943,7-Jul-14,California,San Bernardino,312  E Baseline Street ,1,4,5
154971,5-Jul-14,Oregon,Portland,333 SE 122nd Ave,1,4,5
158055,5-Jul-14,Illinois,Centreville,4700 Piggott Avenue,0,5,5
154844,4-Jul-14,Virginia,Norfolk,1722 Thurgood Street,0,5,5
156834,2-Jul-14,Pennsylvania,Chester,1400 block of West Congress Street,0,5,5
151659,26-Jun-14,Wisconsin,Milwaukee,24th and Locust,0,5,5
151475,25-Jun-14,Massachusetts,Lowell,Midland Street,0,5,5
150344,21-Jun-14,Tennessee,Memphis,2119 East Alcy Road,0,5,5
144524,8-Jun-14,Florida,Fort Myers,17372 Phlox Drive,5,0,5
144565,8-Jun-14,Alabama,Opp,611 Hardin Street,1,4,5
142818,3-Jun-14,Georgia,Atlanta,Auburn Avenue,1,4,5
136163,17-May-14,District of Columbia,Washington,2200 block of Adams Pl NE,0,5,5
134823,13-May-14,Georgia,Atlanta,Panther Trail and Childress Drive,0,5,5
134052,10-May-14,Georgia,Decatur,Shamrock Dr,2,3,5
129730,27-Apr-14,New York,Troy,Fourth Street,0,5,5
128871,25-Apr-14,Tennessee,Memphis,2000 Chelsea Avenue,2,3,5
127413,20-Apr-14,Illinois,Chicago,6600 South Michigan Ave,0,5,5
124131,9-Apr-14,Illinois,Rockford,300 N Sunset Ave,0,5,5
120621,30-Mar-14,Mississippi,Starkville,N/A,0,5,5
120303,30-Mar-14,North Carolina,Charlotte,4300 Sunset Road,0,5,5
111095,1-Mar-14,Pennsylvania,Pittsburgh,Hamilton Ave,1,4,5
109957,25-Feb-14,Virginia,Glade Spring,33325 Graceland Ln,4,1,5
107433,16-Feb-14,Florida,Jacksonville,1187 S. Edgewood Ave.,1,4,5
107673,16-Feb-14,Indiana,Fort Wayne,Lafayette Street and East Tillman Road,0,5,5
108659,16-Feb-14,Texas,Fort Worth, 115 NW 25th St.,1,4,5
107403,15-Feb-14,Nevada,Las Vegas,Sahara and Maryland ,0,5,5
106394,12-Feb-14,Indiana,Gary,2220 block of Broadway,0,5,5
104721,7-Feb-14,Florida,Miami,Northwest 41st Street and 9th Avenue ,0,5,5
103698,3-Feb-14,Indiana,Franklin,2100 block of Bridlewood Dr,3,2,5
113665,27-Jan-14,Washington,Seattle,2nd Avenue South and South Main Street,1,4,5
100434,25-Jan-14,Illinois,Chicago,S Union Ave and W 51st St,1,4,5
98836,21-Jan-14,New Jersey,Newark,Springfield Avenue ,2,3,5
97365,16-Jan-14,Utah,Spanish Fork,37 N. 630 West,5,0,5
95579,12-Jan-14,Illinois,Elgin,300 block of North St,0,5,5
95550,12-Jan-14,Alabama,Huntsville,University Drive,0,5,5
495588,25-Dec-13,New Jersey,Irvington,371 Nye Ave,3,2,5
495548,21-Dec-13,New Jersey,Trenton,Jersey Street and Home Avenue,1,4,5
495530,15-Dec-13,Texas,Channelview,900 block of Ashland Boulevard,0,5,5
495323,30-Nov-13,Michigan,Lansing,N/A,0,5,5
494155,23-Nov-13,Oklahoma,Tulsa,Pine Street and Harvard Avenue,4,1,5
494072,20-Nov-13,Texas,Houston,8200 block of Sunbury,3,2,5
493882,11-Nov-13,New York,Brooklyn,318 Maujer St,4,1,5
492985,3-Nov-13,California,Perris,2900 block of Perris Boulevard,0,5,5
492914,29-Oct-13,South Carolina,Bradley (Callison),Callison Highway,5,0,5
492393,27-Oct-13,North Carolina,Southern Pines,115 Turner St,1,4,5
481029,12-Oct-13,Oklahoma,Tulsa,12000 E 31st St,0,5,5
480605,20-Sep-13,Texas,Rice,700 block of NW 0149,5,0,5
480470,18-Sep-13,Tennessee,Memphis,1033 Whitaker,1,4,5
480462,17-Sep-13,Florida,Kissimmee,Flying Fortress Avenue,0,5,5
480394,17-Sep-13,California,Stockton,700 block of North Airport Way,2,3,5
480104,15-Sep-13,Colorado,Colorado Springs,1609 South Nevada,0,5,5
479734,10-Sep-13,Connecticut,Bridgeport,Reservoir Ave and Grandview Ave,1,4,5
492276,25-Aug-13,Florida,Lake Butler,1050 Southeast 6th Street,4,1,5
491965,19-Aug-13,Illinois,Chicago,1011 W. Wilson,1,4,5
491898,18-Aug-13,South Carolina,Chesterfield,3217 Center Point Rd,1,4,5
491749,11-Aug-13,Virginia,Portsmouth,1100 block of Mt. Vernon Ave,1,4,5
491461,3-Aug-13,Michigan,Detroit,Murray Hill St,0,5,5
491416,2-Aug-13,New Jersey,Newark,Livingston St. and 18th Avenue,2,3,5
491181,20-Jul-13,New York,Brooklyn,Grove Street,0,5,5
491001,14-Jul-13,Kansas,Wichita,11th Street and Mead,1,4,5
491037,14-Jul-13,Michigan,Grand Rapids (Kentwood),Farmview Ct SE,0,5,5
490932,13-Jul-13,New Jersey,Trenton (Hamilton Township),1100 block of Deutz Ave,1,4,5
490893,7-Jul-13,California,Stockton,2600 block of Connecticut Avenue,1,4,5
490772,7-Jul-13,Illinois,Chicago,11300 block of S Forest Ave,0,5,5
489129,23-Jun-13,Virginia,Virginia Beach,4600 block of Columbus Street,1,4,5
488833,22-Jun-13,Maryland,Baltimore,700 block of N. Kenwood Avenue,1,4,5
488547,21-Jun-13,North Carolina,Greenville,205 Greenville Blvd SW,0,5,5
487715,14-Jun-13,North Carolina,High Point,2201 Little Avenue,0,5,5
487670,10-Jun-13,Illinois,Chicago,5700 block of South Sangamon Street,1,4,5
486998,25-May-13,Virginia,Hampton,1900 block of Coliseum Drive,1,4,5
486327,15-May-13,Michigan,Detroit,9000 block of Carlin,1,4,5
486153,12-May-13,Arizona,Apache Junction,3600 block of East Apache Trail,0,5,5
486142,11-May-13,Indiana,Columbus,E Main Cross St,5,0,5
486056,5-May-13,California,Palo Alto,Bay Road and University Avenue,0,5,5
486005,2-May-13,New Jersey,Newark,804 S. 16th St,0,5,5
485874,28-Apr-13,North Carolina,Charlotte,William Reynolds Drive,0,5,5
485746,22-Apr-13,Louisiana,Harvey,2300 block of Lapalco Boulevard,0,5,5
484333,21-Apr-13,Washington,Federal Way,33300 block of 18th Lane South,5,0,5
484287,14-Apr-13,Kentucky,Lexington,750 East New Circle Rd,1,4,5
483861,6-Apr-13,South Carolina,Greenwood,Tabor Street,1,4,5
483817,31-Mar-13,Washington,Auburn,2802 Auburn Way North,3,2,5
483835,30-Mar-13,California,Atwater,9200 block of Westside Boulevard,3,2,5
482942,17-Mar-13,Florida,Belle Glade,Northwest 16th Street and Northwest Avenue L,0,5,5
482934,17-Mar-13,California,Stockton,1800 block of East Sonora Street,2,3,5
481237,10-Mar-13,Missouri,Kansas City,9331 Hillcrest Rd,0,5,5
480344,12-Feb-13,Utah,Midvale,8286 Adams Street and 450 West Street,4,1,5
480327,11-Feb-13,Delaware,Wilmington,500 North King St,3,2,5
480311,11-Feb-13,California,Vallejo,800 block of Humboldt Street,1,4,5
479573,2-Feb-13,Tennessee,Memphis,2514 Mount Moriah,0,5,5
479554,26-Jan-13,District of Columbia,Washington,2403 Benning Road Northeast,0,5,5
479561,26-Jan-13,Louisiana,Charenton,1000 block of Flat Town Road,2,3,5
479374,21-Jan-13,Louisiana,New Orleans,LaSalle Street and Martin Luther King Jr. Boulevard,0,5,5
479363,19-Jan-13,New Mexico,Albuquerque,2806 Long Lane,5,0,5
478911,31-Dec-12,California,Sacramento,2nd Street and K Street,2,3,5
2308395,21-May-22,Washington,Tacoma,S Yakima Ave and South 56th St,0,4,4
2307631,20-May-22,Florida,Kissimmee,2331 Old Dixie Hwy,1,3,4
2307813,20-May-22,Louisiana,New Orleans,St. Claude Ave and Forstall St,1,3,4
2305208,17-May-22,California,Palo Alto (East Palo Alto),2500 block of Fordham St,1,3,4
2304029,15-May-22,North Carolina,Elizabeth City,901 S Martin Luther King Jr Dr,0,4,4
2299660,11-May-22,Illinois,Chicago,6800 block of S Ashland Ave,0,4,4
2299793,11-May-22,Missouri,Saint Louis,5000 block of N Kingshighway Blvd,1,3,4
2299126,11-May-22,Indiana,Indianapolis,701 Canal Walk,0,4,4
2298519,10-May-22,Pennsylvania,Philadelphia,Allegheny Ave and G St,0,4,4
2298591,10-May-22,Maryland,Baltimore,700 block of N Rose St,1,3,4
2299176,10-May-22,Texas,Brookshire,Purdy and 4th St,1,3,4
2297823,9-May-22,Michigan,Detroit,12600 block of McCoy Cir,0,4,4
2296808,7-May-22,Texas,Garland,800 block of Magnolia Dr,2,2,4
2296224,7-May-22,Florida,Miami,NW 37th St and NW 32nd Ave,0,4,4
2294515,3-May-22,Kansas,Cowley (county),N/A,0,4,4
2292613,1-May-22,South Carolina,North Charleston,US-52 and Ashley Phosphate Rd,1,3,4
2291185,29-Apr-22,Tennessee,Jackson,310 North Pkwy,2,2,4
2291534,29-Apr-22,Mississippi,Laurel,Ferrell St and Poplar Dr,0,4,4
2290026,28-Apr-22,Alabama,Bessemer,1800 block of Berkley Ave,1,3,4
2288928,27-Apr-22,Illinois,Chicago,4400 block of W Jackson Blvd,0,4,4
2288842,27-Apr-22,Mississippi,Biloxi,2688 Beach Blvd,4,0,4
2289382,27-Apr-22,Arizona,Phoenix,6719 W Thomas Rd,0,4,4
2287581,25-Apr-22,Alabama,Birmingham,821 3rd Ave W,1,3,4
2286363,24-Apr-22,South Carolina,Myrtle Beach,12th Ave N and Withers Alley,1,3,4
2285772,23-Apr-22,Illinois,Chicago,2000 block of W 51st St,2,2,4
2285612,23-Apr-22,North Carolina,Rocky Mount,1171 Jefferies Rd,0,4,4
2285242,22-Apr-22,Ohio,Cincinnati,Kemper Ln and E McMillan St,0,4,4
2285267,21-Apr-22,Arkansas,Mountain View,646 Northcutt Rd,4,0,4
2281171,17-Apr-22,Pennsylvania,Philadelphia,2800 block of Orkney St,0,4,4
2281541,17-Apr-22,Oregon,Portland,16150 SE Stark St,1,3,4
2281164,17-Apr-22,California,Sacramento,7200 block of Franklin Blvd,1,3,4
2281483,17-Apr-22,Florida,Miami,15020 South River Dr,1,3,4
2280495,16-Apr-22,Maryland,Baltimore,5300 block of Maple Ave,1,3,4
2281244,16-Apr-22,Nevada,North Las Vegas,4900 block of Support St,0,4,4
2280504,15-Apr-22,California,Stockton,300 block of Coventry Dr,2,2,4
2277011,12-Apr-22,New York,Bronx,2825 Olinville Ave,1,3,4
2275242,10-Apr-22,Louisiana,Baton Rouge,2700 block of Lorraine St,0,4,4
2274855,9-Apr-22,District of Columbia,Washington,O St SW and Half St SW,0,4,4
2274296,9-Apr-22,Florida,Miami,6816 NW 15th Ave,0,4,4
2270747,4-Apr-22,Kentucky,Covington,Russell St and W 16th St,0,4,4
2270578,4-Apr-22,Connecticut,Hartford,Bedford St and Mather St,1,3,4
2269429,3-Apr-22,New York,Buffalo,400 block of Genesee St,0,4,4
2269745,3-Apr-22,California,San Francisco,670 Brunswick St,2,2,4
2268723,2-Apr-22,North Carolina,Shelby,1851 E Dixon Blvd,1,3,4
2269059,2-Apr-22,Colorado,Colorado Springs,2400 block of Barkman Dr,0,4,4
2269034,2-Apr-22,Louisiana,Shreveport,2025 Marshall St,1,3,4
2269259,1-Apr-22,South Carolina,Walterboro,1900 Block of Logan Farm Rd,0,4,4
2265029,26-Mar-22,Ohio,Cleveland,1437 St Clair Ave NE,0,4,4
2263608,25-Mar-22,Colorado,Colorado Springs,820 Citadel Dr E,2,2,4
2260129,22-Mar-22,California,Stockton,1800 West Lane,1,3,4
2259262,21-Mar-22,Connecticut,Waterbury,23 Scovill St,0,4,4
2259413,21-Mar-22,Illinois,Chicago,1650 E 79th St,2,2,4
2258324,20-Mar-22,Wisconsin,Milwaukee,2822 W Melvina St,0,4,4
2258224,20-Mar-22,Texas,Houston,2955 S Sam Houston Pkwy E,1,3,4
2258156,20-Mar-22,Texas,Austin,E 6th St and Neches St,0,4,4
2256453,18-Mar-22,Texas,Fort Worth,1600 block of NW Loraine St,1,3,4
2257132,17-Mar-22,Michigan,Lansing,2200 block of E Michigan Ave,0,4,4
2256398,17-Mar-22,Illinois,Chicago,4100 block of W Monroe St,0,4,4
2255816,17-Mar-22,Florida,Fort Lauderdale,1300 W Broward Blvd,2,2,4
2256080,16-Mar-22,New Jersey,Irvington,862 18th Ave,1,3,4
2253714,14-Mar-22,Pennsylvania,Reading,1300 block of Meade St,1,3,4
2252500,13-Mar-22,New York,Rochester,471 State St,2,2,4
2252719,12-Mar-22,Maryland,Baltimore,Gwynn Oak Ave and Liberty Heights Ave,3,1,4
2253654,12-Mar-22,Alabama,Autaugaville,200 block of N Pickett St,1,3,4
2251416,11-Mar-22,Ohio,Columbus,1644 E Dublin-Granville Rd,2,2,4
2249608,7-Mar-22,Tennessee,Knoxville,5800 block of Primus Rd,0,4,4
2247617,6-Mar-22,Minnesota,Minneapolis,2720 Blaisdell Ave,1,3,4
2247842,6-Mar-22,Kentucky,Louisville,601 E Jefferson St,0,4,4
2247828,6-Mar-22,Texas,Lubbock,1800 block of Parkway Dr,0,4,4
2248613,6-Mar-22,Louisiana,Monroe,1051 Martin Luther King Junior Drive,0,4,4
2247747,5-Mar-22,Arizona,Glendale,4810 W Glendale Ave,1,3,4
2247025,5-Mar-22,Georgia,Atlanta,I-75 and Langford Pkwy,0,4,4
2245620,2-Mar-22,Maryland,Baltimore,Walbrook Ave and N Dukeland St,1,3,4
2243285,27-Feb-22,Louisiana,Alexandria,3700 block of 3rd St,0,4,4
2242345,26-Feb-22,South Carolina,North Charleston,2622 S Allen Dr,1,3,4
2241857,25-Feb-22,Louisiana,Baton Rouge,6401 Bluebonnet Blvd,2,2,4
2241299,24-Feb-22,Texas,San Antonio,90 Lanark Dr,0,4,4
2238575,21-Feb-22,Minnesota,Saint Paul,488 Humboldt Ave,1,3,4
2238657,20-Feb-22,Nebraska,Omaha,1817 N 33rd St,0,4,4
2238165,20-Feb-22,Iowa,Des Moines,100 block of Water St,0,4,4
2238403,20-Feb-22,Oregon,Portland,SE Foster Rd and 128th Ave,1,3,4
2238312,20-Feb-22,Mississippi,Mccomb,Minnesota Ave and 6th St,1,3,4
2237058,19-Feb-22,North Carolina,Durham,1400 E Cornwallis Rd,2,2,4
2236857,18-Feb-22,Maryland,Temple Hills (Marlow Heights),4200 block of 28th Ave,2,2,4
2236155,17-Feb-22,Pennsylvania,Philadelphia,164 W Chelten Ave,0,4,4
2235366,16-Feb-22,Florida,Miami,NW 99th St and NW 21st Ave,1,3,4
2234868,15-Feb-22,Illinois,Joliet,700 block of Francis St,1,3,4
2232287,12-Feb-22,California,West Hollywood,401 N La Cienega Blvd,0,4,4
2232476,12-Feb-22,Arkansas,Little Rock,200 block of E 7th St,1,3,4
2231921,11-Feb-22,Missouri,Springfield,E Kearney St and N Prospect Ave,0,4,4
2228510,6-Feb-22,California,Fresno,S Clara Ave and E Lorena Ave,2,2,4
2228660,6-Feb-22,North Carolina,Wilmington,200 block of North 31st St,0,4,4
2227759,6-Feb-22,Florida,Fort Lauderdale,5280 FL-7,0,4,4
2227187,5-Feb-22,New Mexico,Las Cruces,1900 block of Gladys Dr,1,3,4
2224013,31-Jan-22,North Carolina,Raleigh,3120 New Bern Ave,1,3,4
2223019,30-Jan-22,Georgia,Augusta,2623 Deans Bridge Rd,1,3,4
2222557,29-Jan-22,Missouri,Saint Louis,4900 block of Cote Brilliante,3,1,4
2222383,29-Jan-22,Georgia,Atlanta,899 Martin Luther King Jr Dr NW,1,3,4
2222766,29-Jan-22,California,Bakersfield,10612 Rosedale Hwy,0,4,4
2215955,19-Jan-22,Maryland,Baltimore,E Monument St and N Montford Ave,3,1,4
2215256,19-Jan-22,Louisiana,New Orleans,7800 block of Keats St,0,4,4
2213456,16-Jan-22,Georgia,Savannah,1100 Graydon St,1,3,4
2212203,15-Jan-22,Tennessee,Knoxville,2700 block of Tarleton Ave,0,4,4
2210480,13-Jan-22,New York,Brooklyn,1014 E 92nd St,1,3,4
2209840,12-Jan-22,Illinois,Chicago,S King Dr and E 63rd St,0,4,4
2207435,9-Jan-22,California,Fresno,724 E Olive Ave,0,4,4
2206813,8-Jan-22,Texas,Houston,7136 Clarewood Dr,1,3,4
2205024,4-Jan-22,Mississippi,Jackson,3207 W Capitol St,1,3,4
2202976,2-Jan-22,Texas,Corsicana,1100 block of S 29th St,2,2,4
2202727,2-Jan-22,Texas,San Antonio,427 Montrose,2,2,4
2202025,1-Jan-22,Missouri,Columbia,122 S 9th St,0,4,4
2201641,1-Jan-22,Wisconsin,Kenosha,1708 52nd St,1,3,4
2202001,1-Jan-22,Illinois,Peoria,2000 block of SW Adams St,2,2,4
2201848,1-Jan-22,Indiana,South Bend,1500 block of S Miami St,0,4,4
2201677,1-Jan-22,Colorado,Denver,1919 Blake St,2,2,4
2201535,31-Dec-21,Maryland,Capitol Heights,Cindy Ln,0,4,4
2201052,30-Dec-21,Missouri,Kirksville,700 block of E Dodson St,3,1,4
2198014,27-Dec-21,Ohio,Youngstown,2626 Tyrell Ave,1,3,4
2200720,27-Dec-21,Alabama,Mobile,3606 Moffett Rd,1,3,4
2197391,26-Dec-21,Texas,Garland,730 W Walnut St,3,1,4
2198071,26-Dec-21,New York,Buffalo,1300 block of Jefferson Ave,0,4,4
2197328,26-Dec-21,Pennsylvania,Philadelphia,800 block of W Clearfield St,0,4,4
2196827,25-Dec-21,Louisiana,Lafayette,2100 block of NE Evangeline Thruway,0,4,4
2196434,24-Dec-21,Georgia,Roswell,401 Huntington Dr,1,3,4
2196839,24-Dec-21,New York,Brooklyn,1031 Nostrand Ave,0,4,4
2193049,19-Dec-21,Illinois,Lovejoy (Brooklyn),213 Madison St,1,3,4
2191683,17-Dec-21,Virginia,Portsmouth,4105 Portsmouth Blvd,0,4,4
2191752,17-Dec-21,Maryland,Baltimore,600 block of Laurens St,1,3,4
2188999,13-Dec-21,California,Fresno,E Normal Ave and Mayfair Dr S,0,4,4
2188843,13-Dec-21,Pennsylvania,Philadelphia,3400 block of Emerald St,0,4,4
2188066,12-Dec-21,Virginia,Woodbridge,13989 Jefferson Davis Hwy,0,4,4
2187027,11-Dec-21,Illinois,River Grove,3111 River Rd,1,3,4
2186517,10-Dec-21,Michigan,Lansing,Miller Rd and Cedar St,1,3,4
2186858,9-Dec-21,Maryland,Capitol Heights,6700 Walker Mill Rd,0,4,4
2183667,6-Dec-21,Pennsylvania,Philadelphia,1500 block of N 29th St,0,4,4
2182789,5-Dec-21,Michigan,Detroit,5200 block of Marlborough St,2,2,4
2183120,5-Dec-21,Texas,El Paso,2910 Tularosa Ave,1,3,4
2181840,3-Dec-21,Tennessee,Memphis,3885 Elvis Presley Blvd,2,2,4
2177268,28-Nov-21,Pennsylvania,Philadelphia,1300 block of S 50th St,0,4,4
2176667,27-Nov-21,New Jersey,Newark,900 block of Bergen St,1,3,4
2175329,25-Nov-21,Texas,San Antonio,4000 block of Sunrise Creek Dr,2,2,4
2175615,25-Nov-21,South Carolina,Green Sea,Long Branch Swamp Rd,0,4,4
2173531,23-Nov-21,Florida,Lehigh Acres,Cervantes St,0,4,4
2174033,23-Nov-21,Texas,Marshall,700 block of Cross St,1,3,4
2174685,22-Nov-21,North Carolina,Warsaw,101 Matthews St,2,2,4
2171568,20-Nov-21,California,Fresno,3665 N Pleasant Ave,2,2,4
2172018,20-Nov-21,Illinois,Berwyn,6802 W 26th St,0,4,4
2170438,18-Nov-21,Maryland,Cambridge,700 block of Greenwood Ave,1,3,4
2169719,17-Nov-21,Illinois,East Saint Louis,8300 block of State St,1,3,4
2170140,17-Nov-21,New York,Newburgh,William St and Carson Ave,0,4,4
2169494,17-Nov-21,New York,Bronx,815 Burke Ave,1,3,4
2168989,17-Nov-21,Illinois,Chicago,1240 W Randolph St,0,4,4
2167778,15-Nov-21,New York,New York (Manhattan),101 W 141st St,0,4,4
2166953,14-Nov-21,Oregon,Chiloquin,990 Bronco Lane,2,2,4
2166055,13-Nov-21,North Carolina,Winston Salem (Winston-salem),400 block of Gregory St,0,4,4
2167889,13-Nov-21,Louisiana,Houma,100 block of Emma St,0,4,4
2165600,12-Nov-21,Virginia,Richmond,3050 Nine Mile Rd,2,2,4
2165535,12-Nov-21,Alabama,Birmingham,1100 block of 33rd St SW,2,2,4
2163306,9-Nov-21,New York,Rochester,Clifton St and Jefferson Ave,0,4,4
2162196,8-Nov-21,Texas,Victoria,10700 FM 236,3,1,4
2162269,8-Nov-21,Pennsylvania,Philadelphia,200 block of E Louden St,0,4,4
2161323,7-Nov-21,Wisconsin,Kenosha,625 57th St,1,3,4
2161116,6-Nov-21,California,Oakley,33 Malicoat Ave,2,2,4
2161078,6-Nov-21,California,Highland,26998 3rd St,0,4,4
2160838,5-Nov-21,California,Oakland,8400 block of International Blvd,1,3,4
2158524,3-Nov-21,Iowa,Des Moines,11300 block of E 15th St,0,4,4
2157991,2-Nov-21,Alabama,Mobile,4120 Government Blvd,0,4,4
2156175,1-Nov-21,Florida,Orlando,N Orange Ave and Wall St,0,4,4
2157206,1-Nov-21,Texas,San Antonio,1900 block of W Laurel St,0,4,4
2155369,31-Oct-21,Kentucky,Louisville,6210 Shepherdsville Rd,2,2,4
2155517,31-Oct-21,Colorado,Littleton (Lakewood),6200 block of Alameda Ave,2,2,4
2155428,31-Oct-21,Illinois,Flossmoor,3800 block of Ballantrae Way,1,3,4
2155282,31-Oct-21,Texas,Houston,1909 Schilder Dr,1,3,4
2156001,31-Oct-21,Texas,Fort Worth,3700 block of Lebow St,1,3,4
2154851,30-Oct-21,California,Gilroy,400 block of Las Animas Ave,1,3,4
2154422,30-Oct-21,Illinois,Decatur,1100 block of N Union St,0,4,4
2154441,30-Oct-21,Oklahoma,Oklahoma City,NW 122nd St and N Council Rd,0,4,4
2155826,29-Oct-21,Michigan,Kalamazoo,3082 S 9th St,0,4,4
2153285,28-Oct-21,Nevada,Las Vegas,3900 block of E Cheyenne Ave,0,4,4
2153779,28-Oct-21,Tennessee,Nashville,210 N 9th St,1,3,4
2154085,24-Oct-21,California,Gonzales,Foletta Rd,2,2,4
2148946,22-Oct-21,Washington,Renton,16420 SE 128th St,0,4,4
2147114,21-Oct-21,New York,Brooklyn,3008 Glenwood Rd,0,4,4
2147301,21-Oct-21,Washington,Tacoma,4258 Everett St,4,0,4
2147042,20-Oct-21,Michigan,Farwell,9539 S Harrison Ave,4,0,4
2143113,17-Oct-21,Missouri,Saint Louis,8600 block of Goodfellow Blvd,1,3,4
2143499,17-Oct-21,Arkansas,Pine Bluff,University Dr and Pullen Ave,1,3,4
2142402,16-Oct-21,Texas,Killeen,308 S Second St,1,3,4
2139674,12-Oct-21,Mississippi,Meridian,2000 block of 17th St,3,1,4
2137561,10-Oct-21,Iowa,Sioux City,427 Pierce St,0,4,4
2137291,9-Oct-21,Texas,Dallas,3000 block of South Blvd,0,4,4
2137464,9-Oct-21,Colorado,Denver,7300 block of E 22nd Ave,1,3,4
2136230,8-Oct-21,Maryland,Baltimore,2600 block of Jefferson St,0,4,4
2136270,8-Oct-21,District of Columbia,Washington,1700 block of Independence Ave SE,1,3,4
2135536,8-Oct-21,Alabama,Montgomery,1800 block of Cotton Ct,1,3,4
2135508,7-Oct-21,Wisconsin,Milwaukee,W Cherry St and N 8th St,3,1,4
2134657,7-Oct-21,Illinois,Chicago,900 block of N Orleans St,0,4,4
2134359,6-Oct-21,Louisiana,New Orleans,603 General Taylor,2,2,4
2136132,6-Oct-21,Ohio,Cleveland,9200 block of Marshall Ave,0,4,4
2135659,6-Oct-21,Ohio,Cleveland,Marshall Ave and E 93rd St,0,4,4
2133962,5-Oct-21,Illinois,Rockford,400 block of S Independence Ave,1,3,4
2133137,5-Oct-21,Minnesota,Saint Paul,922 Thomas Ave W,0,4,4
2132656,4-Oct-21,Minnesota,Minneapolis,626 W Broadway Ave,0,4,4
2131406,2-Oct-21,Texas,San Antonio,6222 S New Braunfels Ave,1,3,4
2130634,2-Oct-21,Colorado,Aurora,12230 E Colfax Ave,1,3,4
2128023,28-Sep-21,Minnesota,Minneapolis,2700 block of Bloomington Ave,1,3,4
2127374,28-Sep-21,Illinois,Chicago,6500 block of S Calumet Ave,1,3,4
2126450,27-Sep-21,Illinois,Chicago,826 N Ridgeway Ave,1,3,4
2125953,26-Sep-21,California,Oakland,1400 block of 8th Ave,0,4,4
2125613,25-Sep-21,New York,Utica,800 block of Mohawk St,0,4,4
2124887,24-Sep-21,California,Los Angeles,11600 block of Willowbrook Ave,0,4,4
2123301,23-Sep-21,Pennsylvania,Philadelphia,38th St and Aspen St,0,4,4
2122565,22-Sep-21,North Carolina,Fayetteville,1100 block of Charlie Dr,2,2,4
2121031,20-Sep-21,Missouri,Saint Louis,2000 block of St Charles St,1,3,4
2119583,19-Sep-21,New York,Rochester,300 block of Driving Park Ave,2,2,4
2119701,19-Sep-21,Florida,Miami,14900 block of Pierce St,0,4,4
2119736,19-Sep-21,California,Oakland,300 block of 17th St,1,3,4
2119470,18-Sep-21,New York,Bronx,Teller Ave and E 172nd St,1,3,4
2119101,18-Sep-21,Illinois,Danville,3164 E Main St,2,2,4
2118451,17-Sep-21,Georgia,Augusta,519 Broad St,0,4,4
2116343,14-Sep-21,Maryland,Baltimore,1700 block of N Milton Ave,0,4,4
2115947,12-Sep-21,Minnesota,Saint Paul,7th St W and N Walnut St,4,0,4
2114626,12-Sep-21,Texas,Temple,900 block of S 24th St,0,4,4
2122103,12-Sep-21,Illinois,Blue Island,12200 block of S Irving Ave,2,2,4
2114583,11-Sep-21,New York,Utica,700 block of Noyes St,1,3,4
2113623,11-Sep-21,Illinois,Chicago,900 block of E 79th St,1,3,4
2113769,11-Sep-21,New Jersey,Paterson,E 18th St and Fulton Pl,0,4,4
2112450,10-Sep-21,Florida,Orlando,5526 S Orange Blossom Trl,0,4,4
2112252,9-Sep-21,Alabama,Montgomery,1800 block of Cotton Court,1,3,4
2111895,8-Sep-21,Missouri,Saint Louis,4000 block of St Ferdinand Ave,0,4,4
2110346,7-Sep-21,Delaware,Wilmington,A St and New Castle Ave,0,4,4
2108892,5-Sep-21,Missouri,Independence,116 W Lexington Ave,0,4,4
2108560,5-Sep-21,New York,Bronx,4848 White Plains Rd,0,4,4
2115336,5-Sep-21,Missouri,Wyatt,N/A,0,4,4
2108414,5-Sep-21,Texas,Houston,7518 Imogene St,4,0,4
2109384,5-Sep-21,Ohio,Cincinnati,6308 Corbly Rd,0,4,4
2107828,4-Sep-21,Louisiana,Monroe,1600 block of Winnsboro Rd,1,3,4
2107916,4-Sep-21,Alabama,Birmingham,9164 Parkway E,2,2,4
2107875,4-Sep-21,Pennsylvania,Pittsburgh,7300 block of Hamilton Ave,0,4,4
2107621,3-Sep-21,Texas,Austin,9345 US-290,1,3,4
2107168,3-Sep-21,New York,Syracuse,Nelson St and W Marcellus St,0,4,4
2107467,3-Sep-21,Louisiana,New Iberia,927 S Lewis St,1,3,4
2107198,2-Sep-21,New York,Niagara Falls,336 19th St,0,4,4
2104725,31-Aug-21,North Carolina,Elm City,3500 block of London Church Rd,2,2,4
2102991,29-Aug-21,Nevada,Las Vegas,1750 S Rainbow Blvd,1,3,4
2103311,29-Aug-21,Wisconsin,Milwaukee,N 41st St and W Lloyd St,0,4,4
2103035,28-Aug-21,California,San Diego,3100 block of Mission Blvd,0,4,4
2102694,28-Aug-21,Illinois,Chicago,2800 block of W 12th Pl,0,4,4
2101199,27-Aug-21,California,Los Angeles,8400 block of Fountain Ave,0,4,4
2101774,27-Aug-21,West Virginia,Huntington,300 block of Oney Ave,2,2,4
2098246,23-Aug-21,Illinois,Chicago,W Wilson Ave and N Sheridan Rd,0,4,4
2097481,22-Aug-21,Illinois,Carbondale,501 W Cherry St,1,3,4
2097271,22-Aug-21,Michigan,Grand Rapids,1500 block of Linden Ave SE,1,3,4
2096687,21-Aug-21,Illinois,Chicago,3500 block of W Walnut St,0,4,4
2095800,20-Aug-21,Michigan,Flint,2905 Saginaw St,1,3,4
2095116,19-Aug-21,Illinois,Chicago,300 block of E 47th St,0,4,4
2095394,19-Aug-21,Maryland,Edgewood,1700 block of Crimson Tree Way,1,3,4
2094421,18-Aug-21,Maryland,Germantown,19575 Scenery Dr,1,3,4
2094457,18-Aug-21,North Carolina,Durham,Ridgeway Ave and Wabash St,1,3,4
2094035,18-Aug-21,California,Los Angeles,W Jefferson Blvd and Culver Blvd,0,4,4
2092227,16-Aug-21,Michigan,Detroit,4421 Central Ave,1,3,4
2091489,15-Aug-21,Illinois,Chicago,1300 block of E 75th St,0,4,4
2091531,14-Aug-21,Indiana,Indianapolis,Wheeler St and E 28th St,1,3,4
2090949,14-Aug-21,New York,Brooklyn,Lexington Ave and Marcy Ave,0,4,4
2090924,14-Aug-21,New Jersey,Trenton,875 New Willow St,0,4,4
2092110,14-Aug-21,Texas,Wichita Falls,2406 Sheppard Access Rd,0,4,4
2089557,10-Aug-21,Mississippi,Clarksdale,N/A,2,2,4
2085438,8-Aug-21,District of Columbia,Washington,3600 block of New York Ave NE,0,4,4
2085256,7-Aug-21,Alabama,Montgomery,200 block of John Morris Ave,0,4,4
2085071,7-Aug-21,Illinois,Chicago,211 S Maplewood Ave,0,4,4
2084884,7-Aug-21,Virginia,Norfolk,700 block of Granby St,0,4,4
2084889,6-Aug-21,Tennessee,Nashville,1000 block of 43rd Ave North,0,4,4
2082957,4-Aug-21,Pennsylvania,Philadelphia,3653 Germantown Ave,0,4,4
2081884,3-Aug-21,Illinois,Urbana,1204 W Church St,1,3,4
2081131,2-Aug-21,South Carolina,Greenwood,101 Heddy Rd,3,1,4
2079920,1-Aug-21,Louisiana,New Orleans,1600 block of Iberville St,1,3,4
2080390,1-Aug-21,Texas,Nacogdoches,1400 block of Dolph St,1,3,4
2078897,31-Jul-21,Illinois,Chicago,1600 block of E Hayes Dr,1,3,4
2080006,31-Jul-21,Michigan,Saginaw,2700 block of Lynnwood Ave,2,2,4
2078540,29-Jul-21,Iowa,Davenport,Pacific St and West Locust St,0,4,4
2077018,28-Jul-21,District of Columbia,Washington,3400 block of 22nd St SE,0,4,4
2077549,28-Jul-21,Alabama,Montgomery,1800 block of Rosa Parks Ave,1,3,4
2072782,24-Jul-21,Ohio,Columbus,N High St and E 4th Ave,0,4,4
2072342,23-Jul-21,South Carolina,Spartanburg,151 Palisade St,2,2,4
2071982,23-Jul-21,South Carolina,Darlington,505 Oleander Dr,0,4,4
2068568,20-Jul-21,Texas,Jacksonville,16241 TX-110,4,0,4
2068061,19-Jul-21,Illinois,Chicago,3308 W Flournoy St,0,4,4
2066335,18-Jul-21,Ohio,Toledo,5205 Telegraph Rd,1,3,4
2066680,18-Jul-21,North Carolina,Burlington,421 N Church St,0,4,4
2066812,18-Jul-21,California,Walnut Creek,SOS Dr and San Luis Rd,1,3,4
2064260,16-Jul-21,New Hampshire,Manchester,I 293 and Brown Ave,0,4,4
2066249,16-Jul-21,South Carolina,Greenville,840 Mauldin Rd,1,3,4
2065533,15-Jul-21,Massachusetts,Boston,265 Centre St,0,4,4
2063394,14-Jul-21,Delaware,Claymont,50 block of Balfour Ave,2,2,4
2060865,13-Jul-21,Indiana,Indianapolis,4200 block of Arborcrest Dr,0,4,4
2060293,12-Jul-21,New Jersey,Iselin,515 US-1,0,4,4
2060605,12-Jul-21,New York,Corona (Queens),180th St and 145th Dr,0,4,4
2058950,10-Jul-21,Massachusetts,Boston,34 Cameron St,0,4,4
2058837,10-Jul-21,Ohio,Springfield,405 S Burnett Rd,1,3,4
2058421,9-Jul-21,California,Los Angeles,7114 W Manchester Ave,0,4,4
2057427,8-Jul-21,Connecticut,Hartford,Nelson St and Garden St,0,4,4
2053500,5-Jul-21,California,Santa Rosa,1500 block of Beachwood Dr,1,3,4
2055252,5-Jul-21,New York,Buffalo,50 block of Donovan Dr,1,3,4
2052524,4-Jul-21,California,Thermal,Jackson St and Airport Blvd,0,4,4
2054233,4-Jul-21,Ohio,Cleveland,Kinsman Rd and E 139th St,0,4,4
2054132,4-Jul-21,Illinois,Peoria,600 block of Haungs Ave,1,3,4
2052689,4-Jul-21,Illinois,Danville,12 S College St,0,4,4
2053786,4-Jul-21,Missouri,Kansas City,E 43rd St and Indiana Ave,0,4,4
2052058,3-Jul-21,North Carolina,Chadbourn,Broadway Rd,3,1,4
2051763,3-Jul-21,Pennsylvania,Lancaster,50 block of W Orange St,0,4,4
2052471,3-Jul-21,Georgia,Swainsboro,229 S Main St,1,3,4
2052346,3-Jul-21,Illinois,Chicago,1000 block of W 89th St,0,4,4
2050836,2-Jul-21,Virginia,Norfolk,923 Madison Ave,0,4,4
2050353,1-Jul-21,Virginia,Chesapeake,1200 block of Seaboard Ave,2,2,4
2049419,30-Jun-21,Illinois,Chicago,2200 block of S Millard Ave,0,4,4
2049845,30-Jun-21,Texas,Houston,12101 Fondren Rd,3,1,4
2049907,30-Jun-21,Louisiana,Marrero,6500 block of Lapalco Blvd,0,4,4
2050167,30-Jun-21,Delaware,Dover,100 block of S New St,1,3,4
2046574,27-Jun-21,Illinois,Saint Charles,2051 Lincoln Hwy,1,3,4
2047170,27-Jun-21,Tennessee,Memphis,2500 block of Dunn Ave,3,1,4
2047726,27-Jun-21,North Carolina,Greensboro,801 Province Spring Cir,0,4,4
2046781,26-Jun-21,Texas,Houston,4902 Laura Koppe Rd,1,3,4
2045579,26-Jun-21,Illinois,Chicago,6100 block of N McCormick Blvd,1,3,4
2047787,26-Jun-21,Alabama,Fort Deposit,Forest Dr,1,3,4
2045043,25-Jun-21,Ohio,Columbus,I-670 and Neil Ave,0,4,4
2045564,25-Jun-21,Illinois,Chicago,7000 block of S Indiana Ave,0,4,4
2043834,23-Jun-21,Alabama,Montgomery,100 block of Rotary St,2,2,4
2043465,23-Jun-21,New York,Buffalo,114 Hickory St,0,4,4
2043898,23-Jun-21,Illinois,Chicago,4900 block of W Hubbard St,0,4,4
2043715,23-Jun-21,Illinois,Chicago,7000 block of S Vincennes Ave,0,4,4
2041555,21-Jun-21,District of Columbia,Washington,300 block of 50th St NE,0,4,4
2040643,20-Jun-21,Virginia,Richmond,200 block of Crane St,1,3,4
2040991,20-Jun-21,New Jersey,Atlantic City,1700 block of Atlantic Ave,1,3,4
2040732,20-Jun-21,Ohio,Cincinnati,3000 block of Borden St,1,3,4
2040013,19-Jun-21,New Jersey,Newark,525 Elizabeth Ave,0,4,4
2037813,17-Jun-21,Virginia,Petersburg,Virginia Ave and Melville St,0,4,4
2037887,17-Jun-21,North Carolina,Durham,1600 block of Holloway St,2,2,4
2038622,17-Jun-21,Ohio,Cincinnati,3056 Mathers St,1,3,4
2038152,17-Jun-21,New Jersey,Paterson,Rosa Parks Blvd and Hamilton Ave,0,4,4
2035733,14-Jun-21,Georgia,Columbus,3400 8th Ave,2,2,4
2034408,14-Jun-21,Michigan,Lansing,300 block of N Cedar St,2,2,4
2034470,14-Jun-21,Florida,Boynton Beach,I-95,1,3,4
2033605,13-Jun-21,Kentucky,Louisville,5200 block of Robinwood Rd,1,3,4
2031801,11-Jun-21,Washington,Seattle (White Center),9808 16th Ave SW,2,2,4
2032580,11-Jun-21,North Carolina,Winston Salem (Winston-salem),844 E. Devonshire St,1,3,4
2030720,10-Jun-21,Michigan,Detroit,1600 block Calvert Ave,1,3,4
2030639,10-Jun-21,New York,Yonkers,150 Elm St,0,4,4
2029078,8-Jun-21,Tennessee,Nashville,Clarksville Pike and Buena Vista Pike,1,3,4
2026802,6-Jun-21,Missouri,Saint Louis,100 N 7th St,0,4,4
2026651,6-Jun-21,North Carolina,Snow Hill,50 block of Katie Ct,0,4,4
2025260,5-Jun-21,Indiana,Indianapolis,7500 N Shadeland Ave,2,2,4
2025891,4-Jun-21,Michigan,Muskegon,1675 E. Sherman Blvd,1,3,4
2022821,2-Jun-21,Ohio,Toledo,1830 W Bancroft St,0,4,4
2025254,2-Jun-21,Arkansas,Magnolia,Calhoun Rd,0,4,4
2021130,31-May-21,New York,Brooklyn,Knickerbocker Ave,0,4,4
2021398,31-May-21,Missouri,Saint Louis,8800 block of N Broadway,0,4,4
2020535,30-May-21,Illinois,Chicago,6718 S Stony Island Ave,0,4,4
2019155,29-May-21,Texas,San Antonio,3300 block of Fallen Leaf Ln,2,2,4
2019384,29-May-21,Missouri,Saint Louis,10466 W Florissant Ave,1,3,4
2015849,26-May-21,Illinois,Chicago,7200 block of S Princeton Ave,1,3,4
2014343,24-May-21,Michigan,Inkster,27000 block of Rosewood St,2,2,4
2014381,24-May-21,Ohio,West Jefferson,127 Jackson St,4,0,4
2012971,23-May-21,Illinois,Chicago,3344 W Ohio St,0,4,4
2013595,23-May-21,New York,Bay Shore,135 S Clinton Ave,0,4,4
2013096,23-May-21,Virginia,Norfolk,3100 block of Westminster Ave,0,4,4
2012345,22-May-21,Delaware,Wilmington,800 block of N Pine St,0,4,4
2010083,20-May-21,Indiana,Evansville,800 block of Shadewood Ave,1,3,4
2005991,16-May-21,Ohio,Cincinnati,7751 Reading Rd,1,3,4
2005776,16-May-21,Georgia,Atlanta,630 Travis St NW,0,4,4
2006621,16-May-21,Georgia,Columbus,2727 Manchester Expy,0,4,4
2005238,15-May-21,District of Columbia,Washington,3900 block of Minnesota Ave NE,1,3,4
2004413,14-May-21,Pennsylvania,Philadelphia,5600 block of Market St,0,4,4
2003383,13-May-21,Georgia,Augusta,201 E Telfair St,2,2,4
2003167,13-May-21,District of Columbia,Washington,200 block of 37th Pl SE,1,3,4
2002269,12-May-21,Pennsylvania,Philadelphia,5500 block of Kingsessing Ave,1,3,4
2002286,12-May-21,Georgia,Buford,2910 Buford Dr NE,2,2,4
2001137,11-May-21,Maryland,Baltimore,800 block of W Lexington St,0,4,4
1999909,9-May-21,California,Los Angeles,6112 W Afton Pl,1,3,4
1999423,9-May-21,New Jersey,Newark,378 Chancellor Ave,0,4,4
1998865,8-May-21,California,Citrus Heights,7440 Auburn Blvd,0,4,4
1998693,8-May-21,California,Oakland,1440 block of Lakeshore Ave,0,4,4
1998537,8-May-21,Michigan,Detroit,15700 block of Plymouth Rd,0,4,4
1999307,8-May-21,California,Compton,15100 block of S Lime Ave,2,2,4
1998602,8-May-21,Wisconsin,Milwaukee,900 block of S 10th St,0,4,4
1996236,5-May-21,Illinois,Chicago,6900 block of S Cornell Ave,0,4,4
1993090,2-May-21,Ohio,Columbus,491 Park St,0,4,4
1993664,2-May-21,Pennsylvania,Philadelphia,5200 block of Burton St,1,3,4
1993221,2-May-21,Maryland,Baltimore,1500 block of Washington Blvd,1,3,4
1992570,2-May-21,Minnesota,Saint Paul,843 Selby Ave,0,4,4
1992127,1-May-21,Delaware,Wilmington,800 block of N Pine St,0,4,4
1992469,1-May-21,Florida,Clewiston,1117 Harlem Academy Ave,1,3,4
1991347,25-Apr-21,Texas,Palestine,1101 W Palestine Ave,0,4,4
1987235,25-Apr-21,Alabama,Phenix City,1700 Highway 280 Bypass,0,4,4
1986593,25-Apr-21,Arkansas,Little Rock,1900 E 6th St,1,3,4
1979684,16-Apr-21,Michigan,Detroit,Conant St and Minnesota St,0,4,4
1978561,15-Apr-21,District of Columbia,Washington,1800 block of West Virginia Ave NE,0,4,4
1979869,15-Apr-21,Louisiana,Lake Charles,4101 5th Ave,1,3,4
1978652,15-Apr-21,Illinois,Chicago,600 block of N Sawyer Ave,0,4,4
1976538,13-Apr-21,Maryland,Baltimore,2300 block of Hoffman St,0,4,4
1974943,11-Apr-21,Kansas,Wichita,200 block of N Battin St,1,3,4
1975004,11-Apr-21,Washington,Seattle,306 23rd Ave S,0,4,4
1974088,10-Apr-21,Tennessee,Memphis,385 Western Park Dr,1,3,4
1973809,10-Apr-21,Michigan,Allendale,4926 Becker Dr,0,4,4
1973692,10-Apr-21,Missouri,Koshkonong,US-63 and MO-F,1,3,4
1975405,10-Apr-21,Connecticut,Waterbury,36 Gasparri Ln,0,4,4
1973435,7-Apr-21,Ohio,Dayton,Hoover Ave and Summit Square,0,4,4
1969899,6-Apr-21,District of Columbia,Washington,4100 block of Ames St NE,0,4,4
1970245,6-Apr-21,Michigan,Detroit,6100 block of Lodewyck St,1,3,4
1969633,4-Apr-21,Texas,Beaumont,6035 S M L King Jr Pkwy,0,4,4
1964085,28-Mar-21,Illinois,Chicago,I-57 and W 127th St,0,4,4
1964030,28-Mar-21,Texas,San Antonio,2011 Dollarhide Ave,0,4,4
1963052,27-Mar-21,Illinois,Chicago,500 block of N Leamington Ave,0,4,4
1962686,27-Mar-21,Illinois,River Grove,Belmont Ave,1,3,4
1964271,26-Mar-21,Virginia,Norfolk,100 block of W Balview Ave,0,4,4
1960283,23-Mar-21,Alabama,Aliceville,1st Ave SW and 15th St,2,2,4
1959549,22-Mar-21,Michigan,Detroit,13300 block of Davidson St,1,3,4
1956081,18-Mar-21,Oregon,Gresham,750 E Powell Blvd,0,4,4
1955948,18-Mar-21,Louisiana,New Orleans,2400 Annette St,0,4,4
1952662,14-Mar-21,Illinois,Chicago,2600 block of E 77th St,0,4,4
1953202,14-Mar-21,Florida,Tampa,10101 US-92,0,4,4
1951681,13-Mar-21,Florida,Orlando,200 block of Ring Rd,1,3,4
1951476,12-Mar-21,North Carolina,Greensboro,100 block of Huffman St,1,3,4
1951383,12-Mar-21,Texas,Austin,7408 Cameron Rd,0,4,4
1950346,11-Mar-21,New Mexico,Ohkay Owingeh (Chamita),89 Rio Arriba Co Rd 56,1,3,4
1950471,11-Mar-21,Pennsylvania,Philadelphia,1400 block of N 76th St,2,2,4
1949977,10-Mar-21,Texas,Houston,6300 Ranchester Dr,3,1,4
1948233,8-Mar-21,Florida,Clearwater,US-19 ALT and Drew St,1,3,4
1948470,7-Mar-21,Mississippi,Edwards,607 Wallace Dr,0,4,4
1941669,28-Feb-21,Indiana,East Chicago,1205 W Chicago Ave,0,4,4
1940791,28-Feb-21,Delaware,Dover,21 S Little Creek Rd,0,4,4
1941647,28-Feb-21,South Carolina,Mccormick,437 Talbert Rd,0,4,4
1941210,28-Feb-21,Texas,Houston,13484 Northwest Fwy,0,4,4
1943271,27-Feb-21,Mississippi,Columbus,1200 block of 7th St S,0,4,4
1939789,26-Feb-21,Louisiana,Baton Rouge,4700 block of Paige St,0,4,4
1939958,26-Feb-21,California,San Diego,841 S 45th St,1,3,4
1935235,21-Feb-21,North Carolina,Teachey,Thomas Smith Ln and Bay Rd,0,4,4
1933975,20-Feb-21,Colorado,Grand Junction,1000 block of Teller Ave,1,3,4
1932479,18-Feb-21,Louisiana,Baton Rouge,2047 N Foster Dr,1,3,4
1930463,16-Feb-21,Florida,Saint Petersburg,2968 Emerson Ave S,3,1,4
1928594,13-Feb-21,Indiana,Indianapolis,3800 block of N Sherman Dr,0,4,4
1928205,13-Feb-21,North Carolina,Cary,101 Reed St,1,3,4
1926701,10-Feb-21,Georgia,Atlanta,62 Harwell Rd NW,0,4,4
1924892,9-Feb-21,Texas,Houston,945 W Little York Rd,0,4,4
1923786,6-Feb-21,Louisiana,Thibodaux,1100 block of Tiger Dr,0,4,4
1922354,6-Feb-21,Washington,Tacoma,3634 E McKinley Ave,1,3,4
1921641,5-Feb-21,Pennsylvania,Mohnton,360 E Wyomissing Ave,1,3,4
1924951,5-Feb-21,Mississippi,Benoit,1017 Lake Bolivar Rd,3,1,4
1919399,3-Feb-21,Tennessee,Memphis,800 block of Olympic St,1,3,4
1917661,1-Feb-21,New York,Rochester,400 block of Lyell Avenue,1,3,4
1913708,27-Jan-21,California,Santa Ana,1614 S Standard Ave,0,4,4
1908542,21-Jan-21,California,Oakland,107th Ave and Apricot St,1,3,4
1905423,18-Jan-21,Pennsylvania,Tobyhanna,960 PA-196,0,4,4
1903058,15-Jan-21,Pennsylvania,Philadelphia,5000 block of N 10th St,0,4,4
1899819,11-Jan-21,Florida,Miami,2491 NE 58th St,0,4,4
1897878,9-Jan-21,Texas,Houston,5828 Martin Luther King Blvd,1,3,4
1896384,6-Jan-21,Texas,Livingston,201 Maple Ln,2,2,4
1894822,4-Jan-21,Louisiana,New Orleans,1600 block of N Galvez St,0,4,4
1893953,3-Jan-21,Oregon,Gresham,NE 181st Ave and NE San Rafael St,0,4,4
1893877,3-Jan-21,California,Santa Barbara,1200 block of Liberty St,2,2,4
1892704,1-Jan-21,Texas,Amarillo,2650 Dumas Dr,1,3,4
1891720,1-Jan-21,Illinois,Galesburg,1000 block of Monroe St,0,4,4
1891461,31-Dec-20,Indiana,Indianapolis,8215 Center Run Road,1,3,4
1890946,31-Dec-20,Oregon,Happy Valley,9200 block of SE Idleman Rd,0,4,4
1886913,26-Dec-20,Florida,Tampa,N 20th St and E 7th Ave,2,2,4
1886849,26-Dec-20,Florida,Miami,NW 61st St and NW 13th Ave,1,3,4
1882214,20-Dec-20,Connecticut,Bridgeport,456 Connecticut Ave,2,2,4
1876727,13-Dec-20,West Virginia,Elkview,1384 Cemetery Hill Dr,4,0,4
1877043,12-Dec-20,California,San Bernardino,900 block of N Sierra Way,1,3,4
1876231,12-Dec-20,New York,Copiague,2336 Great Neck Rd,2,2,4
1876039,12-Dec-20,New York,Brooklyn,574 Warren St,0,4,4
1876552,12-Dec-20,Maryland,Hyattsville (Landover),8600 block of Old Ardmore Rd,2,2,4
1877628,10-Dec-20,Georgia,Tifton,700 block of 17 1/2 St,0,4,4
1871627,5-Dec-20,California,Hayward,25000 block of Eldridge Ave,1,3,4
1869748,4-Dec-20,Illinois,Chicago,4400 block of W Adams St,0,4,4
1867006,1-Dec-20,Pennsylvania,Morrisville,1 Makefield Rd,1,3,4
1866100,30-Nov-20,Alaska,Palmer,335 N Valley Way,4,0,4
1864177,28-Nov-20,Louisiana,New Orleans,7001 Lawrence Rd,0,4,4
1859110,22-Nov-20,New Jersey,Trenton,Stuyvesant Ave and Hoffman Ave,0,4,4
1858455,22-Nov-20,Illinois,Chicago,700 block of E 101st St,1,3,4
1859186,22-Nov-20,Louisiana,New Orleans,9232 Chef Menteur Hwy,1,3,4
1858965,21-Nov-20,Nebraska,Bellevue,1307 Cornhusker Rd,2,2,4
1856417,19-Nov-20,Florida,Haines City,422 N 15th St,1,3,4
1856338,18-Nov-20,South Carolina,Florence,500 block of Gaillard St,0,4,4
1854207,17-Nov-20,Tennessee,Jackson,Honey Bear Cove,0,4,4
1854149,16-Nov-20,Florida,Miami,200 block of S Biscayne River Dr,0,4,4
1853615,16-Nov-20,Illinois,Chicago,700 block of S Pulaski Rd,0,4,4
1854076,16-Nov-20,Illinois,Chicago,2700 block of S State St,0,4,4
1853089,15-Nov-20,Georgia,Jonesboro,500 Block of Museum Cir,2,2,4
1852604,14-Nov-20,South Carolina,Sumter,1008 Marilyn Ave,3,1,4
1852853,14-Nov-20,Missouri,Fulton,1915 N Bluff St,0,4,4
1852161,14-Nov-20,Ohio,Cincinnati,400 block of Kings Run Dr,0,4,4
1847840,9-Nov-20,Texas,Fort Worth,5310 E Rosedale St,0,4,4
1846712,8-Nov-20,Virginia,Virginia Beach,3700 block of Whitney Ct,0,4,4
1846764,7-Nov-20,Kansas,Ogden,225 Riley Ave,0,4,4
1845690,7-Nov-20,South Carolina,Rock Hill,241 Albright Rd,1,3,4
1845477,6-Nov-20,Louisiana,New Orleans,8622 Belfast St,2,2,4
1843360,4-Nov-20,Missouri,Jefferson City,1299 Lafayette St,0,4,4
1840600,1-Nov-20,Arizona,Tucson,2500 block of E Aerospace Pkwy,2,2,4
1840265,1-Nov-20,Indiana,Evansville,664 E Illinois St,0,4,4
1840364,1-Nov-20,Oklahoma,Oklahoma City,10601 S Western Ave,1,3,4
1841432,1-Nov-20,North Carolina,Winston Salem (Winston-salem),3900 block of Glen Hi Rd,1,3,4
1839628,31-Oct-20,California,Sacramento,2800 block of Normington Dr,0,4,4
1839462,31-Oct-20,California,Anaheim,1210 S State College Blvd,0,4,4
1840544,31-Oct-20,Nevada,North Las Vegas,3700 block of Iverson Ln,0,4,4
1839112,30-Oct-20,Maryland,Waldorf,2177 Crain Hwy,1,3,4
1839065,30-Oct-20,Illinois,Chicago,11613 S Vincennes Ave,1,3,4
1838368,29-Oct-20,Florida,Winter Garden,Center St and 11th St,0,4,4
1837146,28-Oct-20,Virginia,Roanoke,1400 block of Rorer Ave SW,0,4,4
1837429,28-Oct-20,New Jersey,Newark,381 S 6th St,1,3,4
1835030,25-Oct-20,Texas,San Antonio,2800 block of W Hutchins Pl,1,3,4
1834280,25-Oct-20,North Carolina,Raleigh,1731 Trawick Rd,1,3,4
1832014,22-Oct-20,Florida,Miami,1830 NW 50 St,1,3,4
1831995,22-Oct-20,Massachusetts,Boston,Columbia Rd and Stanwood St,0,4,4
1831091,22-Oct-20,Maryland,Baltimore,500 block of W Franklin St,0,4,4
1830822,21-Oct-20,Mississippi,Canton,1427 W Peace St,2,2,4
1830092,20-Oct-20,Texas,Houston,2117 Chenevert St,3,1,4
1828796,19-Oct-20,Louisiana,New Orleans,2599 N Prieur St,1,3,4
1827437,18-Oct-20,Maryland,Annapolis,100 block of Clay St,1,3,4
1828019,18-Oct-20,Tennessee,Nashville,1100 block of W Grove Ave,0,4,4
1825525,16-Oct-20,Florida,Orlando,2000 block of N Forsyth Rd,3,1,4
1826675,16-Oct-20,California,San Francisco,200 block of Scherwin St,1,3,4
1824979,15-Oct-20,Louisiana,Lafayette,100 block of Laser Ln,2,2,4
1824073,14-Oct-20,Pennsylvania,Philadelphia,3900 block of  Buist Ave,0,4,4
1821496,11-Oct-20,Georgia,Atlanta,330 W Peachtree St NW,0,4,4
1820156,10-Oct-20,Illinois,Chicago,100 block of S Keeler Ave,1,3,4
1819955,10-Oct-20,Missouri,Saint Louis (Jennings),8800 block of Shannon Fox Cir,2,2,4
1817184,7-Oct-20,New York,Brooklyn,181 Hegeman Ave,1,3,4
1815308,5-Oct-20,District of Columbia,Washington,400 block of Orange St SE,1,3,4
1813583,3-Oct-20,California,Sacramento,Roanoke Ave and Haywood St,1,3,4
1812972,2-Oct-20,California,Los Angeles,51st St and Hoover St,0,4,4
1812838,2-Oct-20,Washington,Seattle,9700 block of 59th Ave S,0,4,4
1810696,30-Sep-20,North Carolina,Greensboro,700 block of Milton St,0,4,4
1810881,30-Sep-20,Florida,Jacksonville,12517 Beach Blvd,0,4,4
1809484,29-Sep-20,Ohio,Painesville,100 block of Morse Ave,2,2,4
1806806,27-Sep-20,Ohio,Sandusky,Hancock St and Neil St,1,3,4
1808628,27-Sep-20,California,San Bernardino,900 block of N Sierra Way,1,3,4
1807096,27-Sep-20,Tennessee,Nashville,619 Millwood Dr,0,4,4
1807046,26-Sep-20,Pennsylvania,Philadelphia,100 block of N Lindenwood St,0,4,4
1806035,26-Sep-20,Alabama,Enterprise,507 Glover Ave,1,3,4
1805722,26-Sep-20,Illinois,Chicago,2400 block of W Lithuanian Plaza Ct,0,4,4
1806500,25-Sep-20,Pennsylvania,Philadelphia,1300 block of Sanger St,0,4,4
1804511,23-Sep-20,Georgia,Hampton,1577 Glynn Ct,1,3,4
1800549,20-Sep-20,New York,Corona (Queens),Merrick Blvd and Foch Blvd,0,4,4
1800514,20-Sep-20,Connecticut,Stamford,Ursula Pl and Dale St,1,3,4
1799748,19-Sep-20,Illinois,Chicago,12200 block of S May St,0,4,4
1799703,19-Sep-20,Illinois,Chicago,6900 block of S Claremont Ave,0,4,4
1800188,19-Sep-20,New Jersey,Plainfield,523 W 3rd St,0,4,4
1799160,18-Sep-20,Arkansas,Little Rock,5311 Mabelvale Pike,0,4,4
1795391,14-Sep-20,Louisiana,Baker,Burgess Dr,0,4,4
1793559,13-Sep-20,Florida,Tampa,5110 N 40th St,0,4,4
1794086,13-Sep-20,Illinois,Chicago,6100 block of S Throop St,1,3,4
1793771,12-Sep-20,Pennsylvania,Philadelphia,N 18th St and Dauphin St,0,4,4
1788168,7-Sep-20,Louisiana,New Orleans,1500 block of Freret St,0,4,4
1786920,6-Sep-20,Illinois,Chicago,S Kingston Ave and E 77th St,0,4,4
1787977,6-Sep-20,Tennessee,Memphis,6555 Lost Oak Dr,0,4,4
1786829,6-Sep-20,Colorado,Commerce City,6700 block of Birch St,0,4,4
1786890,6-Sep-20,Missouri,Saint Louis,5700 block of Minerva Ave,1,3,4
1787387,6-Sep-20,Maryland,Baltimore,4900 block of Reisterstown Rd,0,4,4
1786488,5-Sep-20,Texas,Houston,9940 Fondren Rd,0,4,4
1786449,5-Sep-20,Maryland,Baltimore,2000 block of W Lexington St,1,3,4
1786806,5-Sep-20,Arkansas,Little Rock,400 President Clinton Ave,0,4,4
1805455,3-Sep-20,South Carolina,Anderson,R St and Chase Ave,1,3,4
1785358,3-Sep-20,Florida,Miami,2000 block of NW 71st St,1,3,4
1784570,3-Sep-20,Arkansas,Hensley,Woodson Lateral Rd and I-530,1,3,4
1785593,3-Sep-20,Arkansas,Little Rock,19 Nandina Cir,0,4,4
1783582,2-Sep-20,Pennsylvania,Philadelphia,1800 block of Moore St,2,2,4
1784141,2-Sep-20,Georgia,Albany,1400 block of E Residence Ave,1,3,4
1783928,2-Sep-20,California,Oakland,Kerwin Ave and 105th Ave,0,4,4
1782962,31-Aug-20,Florida,Tallahassee,2660 Old Bainbridge Rd,0,4,4
1780199,30-Aug-20,Illinois,Zion,2300 block of Joppa Ave,1,3,4
1780266,30-Aug-20,Texas,San Antonio,S Olive St and Aransas Ave,2,2,4
1784122,30-Aug-20,Pennsylvania,Philadelphia,5317 Oxford Ave,0,4,4
1780228,29-Aug-20,Nevada,Las Vegas,777 E Twain Ave,2,2,4
1778435,28-Aug-20,Minnesota,Minneapolis,2400 block of Irving Ave N,0,4,4
1778542,28-Aug-20,Pennsylvania,Chester,2900 block of W 2nd St,1,3,4
1777607,27-Aug-20,Oregon,Portland,10500 block of NE Halsey St,1,3,4
1777180,26-Aug-20,Michigan,Pontiac,252 Carriage Circle Dr,3,1,4
1776905,26-Aug-20,South Carolina,Hilton Head Island,Muddy Creek Rd and Spanish Wells Rd,0,4,4
1777400,26-Aug-20,Pennsylvania,Philadelphia,5500 block of Chew Ave,0,4,4
1775249,25-Aug-20,New York,Rochester,70 block of Flower St,0,4,4
1774123,24-Aug-20,Michigan,Detroit,11938 E McNichols Rd,0,4,4
1773194,24-Aug-20,California,Sacramento,1200 block of Helena Ave,1,3,4
1774138,24-Aug-20,Florida,West Palm Beach,1000 block of 18th St,0,4,4
1772513,23-Aug-20,New York,Brooklyn,2946 W 23rd St,1,3,4
1772438,23-Aug-20,Illinois,Champaign,100 block of Kenwood Rd,0,4,4
1773006,23-Aug-20,Illinois,Chicago,6600 S Halsted St,0,4,4
1772764,22-Aug-20,Illinois,Rockford,1300 block of 10th St,1,3,4
1772174,22-Aug-20,Alabama,Bessemer (Hueytown),Allison Bonnet Memorial Dr and Rutledge Dr,1,3,4
1769444,19-Aug-20,Pennsylvania,Philadelphia,700 block of S 55th St,0,4,4
1767851,18-Aug-20,New York,Corona (Queens),35-35 21st St,0,4,4
1767747,18-Aug-20,Illinois,Rockford,3001 Harney Ct,0,4,4
1766574,17-Aug-20,New York,Brooklyn,Atlantic Ave and Hinsdale St,0,4,4
1765658,16-Aug-20,Kentucky,Lexington,1000 block of Newtown Ct,1,3,4
1765624,16-Aug-20,Ohio,Cincinnati,700 block of Chalfonte Pl,1,3,4
1766423,16-Aug-20,Ohio,Cincinnati,700 block of Chalfonte Pl,1,3,4
1765920,16-Aug-20,Oklahoma,Oklahoma City,SW 59th St and Agnew Ave,0,4,4
1765336,15-Aug-20,Michigan,Belleville,24914 Martinsville Rd,4,0,4
1764619,14-Aug-20,New York,New York (Manhattan),111 Lenox Ave,0,4,4
1762997,12-Aug-20,Ohio,Dayton,2049 Catalpa Dr,1,3,4
1760207,9-Aug-20,Mississippi,Jackson,3600 block of Cromwell St,0,4,4
1760261,9-Aug-20,Texas,Houston,9700 Homestead Rd,0,4,4
1758774,8-Aug-20,New York,Albany,First St and Quail St,1,3,4
1757380,6-Aug-20,California,Oakland,4500 block of Fairfax Ave,1,3,4
1756248,5-Aug-20,Illinois,Chicago,700 block of S Karlov Ave,0,4,4
1755566,4-Aug-20,Wisconsin,Madison,333 S Rosa Rd,0,4,4
1755297,4-Aug-20,District of Columbia,Washington,5400 block of Georgia Ave NW,0,4,4
1754640,4-Aug-20,Missouri,Saint Louis,5300 block of Bircher Blvd,1,3,4
1754363,3-Aug-20,New York,Bronx,450 St Ann's Ave,0,4,4
1753320,2-Aug-20,Pennsylvania,Philadelphia,3100 block of Weymouth St,0,4,4
1752790,1-Aug-20,Alabama,Montgomery,1100 block of Eastern Blvd,0,4,4
1752019,31-Jul-20,Pennsylvania,Philadelphia,2500 block of Ingersoll St,1,3,4
1750250,29-Jul-20,Michigan,Detroit,5200 block of Canton St,0,4,4
1749281,28-Jul-20,Delaware,Wilmington,1100 block of Beech St,2,2,4
1749535,28-Jul-20,Wisconsin,Milwaukee,2600 block of W Atkinson Ave,0,4,4
1748134,27-Jul-20,Washington,Federal Way,2410 S 312th St,1,3,4
1746441,26-Jul-20,Michigan,Flint,4462 Corunna Rd,1,3,4
1746658,26-Jul-20,Texas,Mount Enterprise,1039 FM 1798,0,4,4
1746282,26-Jul-20,Kentucky,Louisville,I-64,1,3,4
1746417,26-Jul-20,Colorado,Commerce City,6300 block of Ivanhoe St,1,3,4
1748023,26-Jul-20,Arkansas,Magnolia,1000 block of W Monroe St,0,4,4
1745903,25-Jul-20,North Carolina,Raleigh,503 Bragg St,0,4,4
1746160,25-Jul-20,Florida,Miami,2900 block of Northwest 51st St,1,3,4
1746674,25-Jul-20,Texas,Dallas,525 S Riverfront Blvd,0,4,4
1744407,24-Jul-20,Georgia,Atlanta,Sunset Ave NW and Lester St NW,2,2,4
1743168,23-Jul-20,Virginia,Fairfield,3700 block of Meadowbridge Rd,1,3,4
1743488,23-Jul-20,Virginia,Petersburg,Wesley St,0,4,4
1743108,22-Jul-20,Michigan,Warren,28200 block of Lawson St,0,4,4
1739920,19-Jul-20,Michigan,Detroit,McKinney St and Meuse St,1,3,4
1739917,19-Jul-20,Michigan,Detroit,9122 Dexter Ave,4,0,4
1739097,17-Jul-20,Ohio,Columbus,E 6th Ave and Summit St,0,4,4
1739413,17-Jul-20,Florida,Madison,SW Louisiana Terrace,0,4,4
1736383,15-Jul-20,Louisiana,Shreveport,6725 Buncombe Rd,1,3,4
1734064,13-Jul-20,Kentucky,Louisville,1200 block of W Hill St,1,3,4
1732993,12-Jul-20,New York,Brooklyn,Madison St and Marcus Garvey Blvd,1,3,4
1732365,12-Jul-20,Florida,Fort Lauderdale,3000 block of NW 12th Ct,2,2,4
1733188,12-Jul-20,Illinois,Chicago,700 block of W 66th Pl,1,3,4
1725883,5-Jul-20,Illinois,Chicago,3700 block of W Jackson Blvd,0,4,4
1725802,5-Jul-20,Iowa,Davenport,1000 block of W 3rd St,1,3,4
1726770,5-Jul-20,Arkansas,Helena,1317 Perry St,1,3,4
1725379,5-Jul-20,Wisconsin,Milwaukee,5800 block of W Hope Ave,0,4,4
1726446,5-Jul-20,Texas,Houston,Service Rd and Holcombe Blvd,0,4,4
1725327,5-Jul-20,Maryland,Cambridge,700 block of Weaver Ave,0,4,4
1725635,5-Jul-20,Pennsylvania,Ephrata,6 Blackberry Ln,0,4,4
1727515,5-Jul-20,Mississippi,Greenville,Union St,0,4,4
1725025,4-Jul-20,Maryland,Temple Hills (Marlow Heights),4600 Dallas Pl,1,3,4
1725098,4-Jul-20,Illinois,Chicago,8300 block of S Kingston Ave,1,3,4
1724887,4-Jul-20,Louisiana,Baton Rouge,11300 block of Greenwell Springs Rd,0,4,4
1724219,4-Jul-20,Mississippi,Jackson,6340 Ridgewood Ct Dr,1,3,4
1723897,3-Jul-20,Alabama,Birmingham (Hoover),2000 Riverchase Galleria,1,3,4
1724273,3-Jul-20,Maryland,Baltimore,700 block of S Woodington Rd,0,4,4
1723352,2-Jul-20,Massachusetts,Somerville,5 River Rd,0,4,4
1722142,1-Jul-20,California,Oakland,MacArthur Fwy and 106th Ave,0,4,4
1729506,1-Jul-20,Louisiana,Lake Charles,1600 block of Moss St,0,4,4
1721669,30-Jun-20,Massachusetts,Boston,14 Circuit St,1,3,4
1720761,30-Jun-20,Illinois,Chicago,350 W Chicago Ave,0,4,4
1721572,30-Jun-20,Ohio,Dayton,3500 block of Stanford Pl,0,4,4
1722317,30-Jun-20,Arkansas,Greenbrier,123 Laramie Rd,0,4,4
1720834,29-Jun-20,California,Sylmar,Osborne St and Foothill Blvd,0,4,4
1720655,29-Jun-20,South Dakota,Sioux Falls,902 N Prairie Ave,1,3,4
1719693,28-Jun-20,Pennsylvania,Philadelphia,1900 block of E Somerset St,2,2,4
1718966,27-Jun-20,Illinois,Chicago,3100 block of S Rhodes Ave,2,2,4
1718463,27-Jun-20,Illinois,Peoria,1400 block of SW Jefferson St,0,4,4
1718238,27-Jun-20,New York,Brooklyn,Rockaway Pkwy and Ave B,0,4,4
1719645,27-Jun-20,Arkansas,Blytheville,600 block of Parkway Dr,3,1,4
1718292,26-Jun-20,California,Fresno,Pico Ave,0,4,4
1717173,26-Jun-20,Arizona,Phoenix,5035 W McDowell Rd,0,4,4
1717543,25-Jun-20,Pennsylvania,Philadelphia,Emerald St and E Atlantic St,0,4,4
1716944,25-Jun-20,Connecticut,Bridgeport,527 Huntington Rd,1,3,4
1715616,24-Jun-20,Tennessee,Jackson,Melwood St,0,4,4
1714504,23-Jun-20,Illinois,Chicago,9100 block of South Ellis Ave,0,4,4
1712876,22-Jun-20,Minnesota,Minneapolis,N Morgan Ave and N 16th Ave,0,4,4
1712898,22-Jun-20,Minnesota,Minneapolis,627 W Broadway,0,4,4
1712386,22-Jun-20,Illinois,Chicago,5200 block of S Lowe Ave,0,4,4
1711747,21-Jun-20,New York,Buffalo,W Ferry St and Niagara St,0,4,4
1711690,21-Jun-20,Alabama,Auburn,600 block of Railroad Ave,0,4,4
1713493,21-Jun-20,Texas,Corpus Christi,5802 Everhart Rd,1,3,4
1711487,21-Jun-20,Illinois,Chicago,2600 block of W Potomac Ave,1,3,4
1710537,20-Jun-20,New York,Bronx,Mount Eden Pkwy and Monroe Ave,0,4,4
1711876,20-Jun-20,Michigan,Detroit,Appoline St and Puritan Ave,0,4,4
1711272,20-Jun-20,Michigan,Saginaw,Livingston Dr and Tausend St,1,3,4
1710920,20-Jun-20,North Carolina,Pinetops,715 E Lashley St,2,2,4
1711134,20-Jun-20,New York,Bronx,Mapes Ave,0,4,4
1708432,17-Jun-20,Illinois,Chicago,1323 W 76th St,0,4,4
1706994,16-Jun-20,Iowa,Fort Dodge,900 block of 10th Ave SW,2,2,4
1706710,15-Jun-20,Illinois,Chicago,W Diversey Ave,0,4,4
1705050,14-Jun-20,Louisiana,Lake Charles,3945 US-90,0,4,4
1705346,14-Jun-20,Louisiana,New Orleans,600 block of S Lopez St,2,2,4
1705355,13-Jun-20,Arkansas,Rison,Carver St and Center St,0,4,4
1704217,12-Jun-20,New York,Bronx,E 233rd St and Bronx River Pkwy,1,3,4
1702276,11-Jun-20,Virginia,Richmond,800 block of N 1st St,0,4,4
1701382,10-Jun-20,Ohio,Toledo,1100 block of Baker St,1,3,4
1700371,8-Jun-20,New York,Brooklyn,512 Bristol St,0,4,4
1700250,8-Jun-20,Tennessee,Memphis,1525 E McLemore Ave,0,4,4
1700234,7-Jun-20,Illinois,Robbins,13600 block of Central Park Ave,1,3,4
1698987,7-Jun-20,Illinois,Chicago,50 block of S Seeley Ave,1,3,4
1698276,6-Jun-20,Ohio,Ironton,1305 S 3rd St,0,4,4
1697541,5-Jun-20,Colorado,Denver,4900 block of Wheeling St,0,4,4
1695998,2-Jun-20,Texas,Dallas,7460 S Westmoreland Rd,1,3,4
1695645,2-Jun-20,Illinois,Chicago,8404 S Colfax Ave,0,4,4
1694735,1-Jun-20,Missouri,Saint Louis,1915 Olive St,0,4,4
1693580,31-May-20,Pennsylvania,Philadelphia,700 block of E Clearfield St,0,4,4
1692513,30-May-20,New Jersey,Paterson,E 23rd St and 10th Ave,0,4,4
1692912,30-May-20,District of Columbia,Washington,300 block of 37th St SE,0,4,4
1690922,28-May-20,Tennessee,Memphis,TN 385 and Kirby Pkwy,0,4,4
1691440,28-May-20,Pennsylvania,Philadelphia,300 block of N 55th St,1,3,4
1690524,27-May-20,Ohio,Cleveland,12800 Euclid Ave,1,3,4
1689419,27-May-20,Pennsylvania,Philadelphia,1800 block of Hart Ln,0,4,4
1688610,26-May-20,Mississippi,Vicksburg,4045 Clay St,0,4,4
1689252,26-May-20,Pennsylvania,Philadelphia,2700 block of N Darian St,0,4,4
1688917,26-May-20,Illinois,Chicago,W Washington Blvd and N Hamlin Blvd,2,2,4
1687219,24-May-20,Missouri,Saint Louis,Union Boulevard and Cote Brilliante Ave,0,4,4
1687037,24-May-20,South Carolina,Myrtle Beach,12th Ave N and Ocean Blvd,0,4,4
1687414,24-May-20,Alabama,Danville,68 Flint Creek Pvt Dr,3,1,4
1686222,23-May-20,Texas,Houston,2900 Travis St,0,4,4
1687097,23-May-20,Michigan,Flint,4100 block of Minerva St,1,3,4
1686685,23-May-20,Illinois,Chicago,3911 W Grenshaw St,1,3,4
1686015,22-May-20,Ohio,Cleveland,11921 Miles Ave,1,3,4
1681602,17-May-20,South Carolina,Charleston,23 Cannon St,0,4,4
1850080,15-May-20,Pennsylvania,Philadelphia,4300 block of Germantown Ave,0,4,4
1679356,13-May-20,Tennessee,Memphis,3500 block of Commerce Cir,0,4,4
1677566,11-May-20,Alabama,Montgomery,Rosa Parks Ave and Courtland Dr,0,4,4
1676121,9-May-20,Missouri,Saint Louis,3500 block of Arkansas Ave,0,4,4
1674802,7-May-20,Maryland,Baltimore,5100 block of Stafford Rd,0,4,4
1673989,6-May-20,Texas,Houston,14200 block of Bridgeport Rd,3,1,4
1673633,6-May-20,Georgia,Albany,1900 block of Meadow Dr,1,3,4
1674299,6-May-20,Tennessee,Memphis,Barron Ave and Dogwood Dr,2,2,4
1671289,3-May-20,Ohio,Columbus,300 block of S Ashburton Rd,0,4,4
1671624,3-May-20,Florida,Jacksonville,2100 block of Brooklyn Rd,1,3,4
1670970,2-May-20,Pennsylvania,Philadelphia,200 block of S Cecil St,0,4,4
1668470,29-Apr-20,Indiana,Indianapolis,451 E Stop 11 Rd,0,4,4
1666461,26-Apr-20,New York,Troy,Jefferson St and 3rd St,0,4,4
1664933,24-Apr-20,Texas,Houston,4714 Ward St,3,1,4
1665735,24-Apr-20,Indiana,Fort Wayne,3233 Diplomat Dr,0,4,4
1661537,18-Apr-20,Maryland,Hyattsville,7500 block of Courtney Pl,2,2,4
1660797,17-Apr-20,North Carolina,Greensboro,4400 block of Beckford Dr,1,3,4
1659862,16-Apr-20,Pennsylvania,Philadelphia,Bustleton Ave and St Vincent St,0,4,4
1659966,15-Apr-20,Mississippi,Jackson,1200 block of Wood Village Dr,1,3,4
1656265,10-Apr-20,Michigan,Muskegon,800 block of Oak St,0,4,4
1655674,8-Apr-20,Michigan,Detroit,1200 block of Payton St,0,4,4
1654971,8-Apr-20,South Carolina,Greenwood,1522 Parkway,1,3,4
1656373,8-Apr-20,Alaska,Anchorage,10600 block of Elmore Rd,0,4,4
1654341,7-Apr-20,Illinois,Chicago,86th Street and Damen Avenue,1,3,4
1652642,5-Apr-20,New York,Brooklyn,181 Rockaway Pky,0,4,4
1652734,5-Apr-20,California,Los Angeles,89th St and Hobart Ave,1,3,4
1652601,4-Apr-20,Texas,Vidor,100 block of Hebert St,0,4,4
1652073,4-Apr-20,Texas,Lubbock,2107 49th St,2,2,4
1651742,3-Apr-20,Kentucky,Louisville,1000 block of Cecil Ave,0,4,4
1649473,31-Mar-20,Georgia,Macon,571 Moreland Ave,3,1,4
1648205,29-Mar-20,Georgia,Atlanta,Ponce de Leon Ave and Parkway Dr,0,4,4
1647661,28-Mar-20,Maryland,Baltimore,1100 block of Washington Blvd,1,3,4
1644111,23-Mar-20,Texas,San Antonio,6700 block of Hickory Springs Dr,0,4,4
1643775,22-Mar-20,South Carolina,Hanahan,Edinburgh Drive,0,4,4
1643157,20-Mar-20,Virginia,Norfolk,800 block of Lincoln St,0,4,4
1642826,20-Mar-20,Missouri,Saint Louis,1923 Prairie Ave,0,4,4
1640007,14-Mar-20,Michigan,Saginaw,4100 block of Gallagher St,2,2,4
1639542,14-Mar-20,New Mexico,Albuquerque,620 block of Arno SE,1,3,4
1639413,13-Mar-20,Illinois,Rockford,4104 Auburn St,0,4,4
1637520,10-Mar-20,Pennsylvania,Chester,200 block of Broomall Street,2,2,4
1636471,8-Mar-20,Illinois,South Holland,I-94 and E 162nd St,0,4,4
1636564,8-Mar-20,California,Ceres,3600 block of Spruce Ave,1,3,4
1635570,7-Mar-20,New Mexico,Albuquerque,1700 block of Rayo Del Sol Dr SW,0,4,4
1627335,23-Feb-20,North Carolina,Clarkton,71 Tina Ln,3,1,4
1625787,20-Feb-20,North Carolina,Greensboro,Martin Luther King Jr Ave and Randolph Dr,0,4,4
1623696,17-Feb-20,Mississippi,Port Gibson,8027 Hwy 61,2,2,4
1622340,15-Feb-20,Louisiana,New Orleans,Dryades St and 2nd St,0,4,4
1616964,8-Feb-20,Texas,Houston,1000 block of Calvin St,1,3,4
1615155,5-Feb-20,Indiana,Indianapolis,4100 block of Shady Oak Dr,4,0,4
1613020,3-Feb-20,Maine,Machias,323 Kennebec Rd,3,1,4
1612597,1-Feb-20,Mississippi,Philadelphia,257 W Beacon St,0,4,4
1610782,31-Jan-20,Louisiana,Shreveport,2000 Grimmett Dr,0,4,4
1611037,31-Jan-20,Florida,Boynton Beach,200 block of NE 1st Ct,1,3,4
1610240,30-Jan-20,California,Merced,100 block of W 18th St,0,4,4
1606554,27-Jan-20,Connecticut,Bridgeport,172 Golden Hill St,0,4,4
1605798,26-Jan-20,New York,Newburgh,1571 NY-300,3,1,4
1600350,18-Jan-20,Texas,South Houston,700 block of Virginia St,2,2,4
1592655,8-Jan-20,Mississippi,Bay Saint Louis,10 Bay Park Way,2,2,4
1588919,5-Jan-20,Georgia,Atlanta,1008 Brady Ave NW,0,4,4
1588308,4-Jan-20,Florida,Ocala,800 block of NW 6th Ter,1,3,4
1586839,2-Jan-20,New York,Brooklyn,6120 3rd Ave,0,4,4
1585746,1-Jan-20,Ohio,Cleveland,1437 St Clair Ave NE,0,4,4
1582197,29-Dec-19,New York,Buffalo,50 block of Henrietta Ave,1,3,4
1581590,27-Dec-19,California,Modesto,1900 block of Vernon Ave,1,3,4
1581476,27-Dec-19,Georgia,Kennesaw,1575 Ridenour Pkwy NW,0,4,4
1579889,25-Dec-19,California,Oakland,2100 block of 34th Ave,0,4,4
1579970,25-Dec-19,Iowa,Coralville,954 Boston Way,1,3,4
1579856,25-Dec-19,Virginia,Richmond,1800 E Main St,1,3,4
1579266,24-Dec-19,Louisiana,New Orleans,6400 block of General Meyer Ave,0,4,4
1578711,21-Dec-19,Louisiana,Edgard,2555 LA-18,0,4,4
1577438,20-Dec-19,Alabama,Tuskegee,2900 block of Davison St,2,2,4
1575175,18-Dec-19,Texas,San Antonio,2418 SW Military Dr,0,4,4
1573471,14-Dec-19,California,Ivanhoe,15700 block of Paradise Ave,0,4,4
1571348,12-Dec-19,Missouri,Saint Louis (Moline Acres),9900 block of Lewis and Clark Blvd,1,3,4
1564524,4-Dec-19,Alabama,Montgomery,500 Eastdale Rd S,2,2,4
1561966,1-Dec-19,Louisiana,New Orleans,2000 block of N Dorgenois St,2,2,4
1562685,1-Dec-19,Michigan,Kalamazoo,6300 block of Proctor St,1,3,4
1558067,25-Nov-19,Florida,Brownsville,NW 29th Ave and 44th St,2,2,4
1556984,24-Nov-19,Louisiana,Cottonport,3846 LA-29,2,2,4
1555879,23-Nov-19,California,Los Angeles,833 S Spring St,0,4,4
1554807,21-Nov-19,Washington,Everett,120 West Casino Rd,0,4,4
1554446,20-Nov-19,California,Richmond,20th St and Roosevelt Ave,0,4,4
1551162,17-Nov-19,Ohio,Cleveland,7100 block of Lawn Ave,0,4,4
1547021,11-Nov-19,Florida,Belle Glade,SW 7th St,0,4,4
1546102,10-Nov-19,Missouri,Kansas City,4704 Independence Ave,0,4,4
1546155,10-Nov-19,Arkansas,Little Rock,3000 block of W 12th St,0,4,4
1545955,9-Nov-19,Michigan,Detroit,3800 block of E McNichols Rd,0,4,4
1546508,9-Nov-19,Georgia,Vidalia,Wiggins St,0,4,4
1545027,8-Nov-19,North Carolina,Raleigh,503 Bragg St,1,3,4
1540863,3-Nov-19,Ohio,Toledo,600 block of Magnolia St,0,4,4
1540841,3-Nov-19,Texas,Nacogdoches,Sandyland Cir and CR 823,1,3,4
1540280,2-Nov-19,Louisiana,Baton Rouge,137 Taylor St,0,4,4
1539557,1-Nov-19,Texas,San Angelo,1616 S Chadbourne St,0,4,4
1537992,30-Oct-19,Pennsylvania,Philadelphia,5026 Walton Ave,4,0,4
1537044,29-Oct-19,Maryland,Baltimore,4700 block of Liberty Heights Ave,1,3,4
1536787,28-Oct-19,Maryland,Baltimore,4160 Pimlico Rd,1,3,4
1536706,27-Oct-19,Michigan,Detroit,East Outer Dr and Helen St,0,4,4
1534704,24-Oct-19,Oklahoma,Oklahoma City,1900 block of NW 12th St,2,2,4
1533166,22-Oct-19,Oklahoma,Oklahoma City (Midwest City),7020 E Green Ave,1,3,4
1531326,21-Oct-19,South Carolina,Sumter,29 Wesmark Blvd,0,4,4
1530965,20-Oct-19,Texas,Port Arthur,1100 block of Vicksburg Ave,1,3,4
1530407,19-Oct-19,Pennsylvania,Duquesne,600 block of Priscilla Ave,0,4,4
1527528,15-Oct-19,Ohio,Columbus,1600 block of Manchester Ave,0,4,4
1526952,13-Oct-19,Ohio,Akron,Main St,0,4,4
1525408,12-Oct-19,Pennsylvania,Philadelphia,700 block of W Russell St,1,3,4
1525628,12-Oct-19,Maryland,Baltimore,800 block of W Lexington St,1,3,4
1523606,10-Oct-19,Florida,Tampa,5410 N Falkenburg Rd,2,2,4
1523204,9-Oct-19,Maryland,Baltimore,1600 block of W North Ave,1,3,4
1520499,6-Oct-19,Colorado,Denver,7100 block of Ruth Way,0,4,4
1519090,3-Oct-19,North Carolina,Roxboro,700 South Foushee St,1,3,4
1518859,3-Oct-19,Missouri,Marshall,S Olson Ave,1,3,4
1517804,1-Oct-19,Missouri,Saint Louis,Leonor K. Sullivan Blvd and Poplar St,0,4,4
1515312,29-Sep-19,Illinois,Round Lake (Round Lake Park),500 block of Fairlawn Ave,1,3,4
1515242,29-Sep-19,Wisconsin,Milwaukee,1500 block of N 29th St,0,4,4
1515128,29-Sep-19,Florida,Jacksonville,2200 block of Clemente Dr,0,4,4
1517360,29-Sep-19,Kansas,Claflin,1500 block of NE 100th Rd,0,4,4
1515327,29-Sep-19,Texas,Beaumont,4100 block of Highland Ave,4,0,4
1511999,24-Sep-19,Illinois,Chicago,2000 block of South Hoyne Ave,1,3,4
1510411,23-Sep-19,Indiana,Gary,1600 block of Connecticut St,2,2,4
1509411,21-Sep-19,Louisiana,New Orleans,Poland Ave and St. Claude Ave,0,4,4
1512486,21-Sep-19,Ohio,Cleveland,3616 East 144th St,4,0,4
1507156,18-Sep-19,Illinois,Chicago,4200 block of W Madison St,3,1,4
1507092,18-Sep-19,California,Wilmington,800 block of Bayview Ave,2,2,4
1505354,16-Sep-19,Wyoming,Cheyenne,3436 E 11th St,2,2,4
1504030,14-Sep-19,Missouri,Saint Louis,5200 block of Tennessee Ave,1,3,4
1504387,14-Sep-19,Georgia,Lagrange,1400 block of Elm St,0,4,4
1501350,10-Sep-19,Illinois,Chicago,2200 block of W Maypole Ave,0,4,4
1499460,8-Sep-19,South Carolina,Sumter,1083 Broad St,2,2,4
1500098,8-Sep-19,Louisiana,Alexandria,2900 block of Cypress St,1,3,4
1499300,7-Sep-19,North Carolina,Whiteville,Brittany Ln,3,1,4
1497180,4-Sep-19,Florida,Jacksonville,400 W 62nd St,0,4,4
1497702,4-Sep-19,Louisiana,Marrero,3044 Sorbonne Dr,2,2,4
1494697,2-Sep-19,North Carolina,Greensboro,5528 W Market St,2,2,4
1495141,2-Sep-19,Illinois,Chicago,6200 block of S King Dr,0,4,4
1494113,1-Sep-19,Connecticut,Hartford,80 Edgewood St,1,3,4
1494669,1-Sep-19,North Carolina,Rocky Mount,521 Country Club Road,0,4,4
1493374,1-Sep-19,Ohio,Toledo,3257 Stickney Ave,0,4,4
1492778,31-Aug-19,North Carolina,Charlotte,10035 Dabney Dr,1,3,4
1492377,31-Aug-19,South Carolina,Moncks Corner,336 Maplewood Rd,0,4,4
1492264,31-Aug-19,Pennsylvania,Philadelphia,4600 block of 4th St,2,2,4
1493429,31-Aug-19,Maryland,Baltimore,900 block of N Monroe St,0,4,4
1492297,31-Aug-19,Maryland,Frederick,600 block of N Market St,0,4,4
1491495,30-Aug-19,Maryland,Baltimore,1600 block of E 29th St,1,3,4
1490466,29-Aug-19,Maryland,Baltimore,2500 block of E Monument St,1,3,4
1487573,25-Aug-19,Illinois,Chicago,8200 block of S Maryland Ave,1,3,4
1487224,24-Aug-19,Massachusetts,Lynn,Warren Street,1,3,4
1489373,23-Aug-19,Georgia,Dublin,200 Riverview Park Dr,0,4,4
1486675,23-Aug-19,Missouri,Saint Louis,1122 Union Blvd,1,3,4
1485340,22-Aug-19,South Carolina,Columbia,851 Bush River Rd,2,2,4
1485548,22-Aug-19,California,Los Angeles,300 block of West Fifth St,0,4,4
1484335,20-Aug-19,Georgia,Atlanta,111 James P Brawley Dr SW,0,4,4
1482199,18-Aug-19,Missouri,Kansas City,770 W 47th St,0,4,4
1478480,12-Aug-19,Mississippi,Greenwood,200 Young St,0,4,4
1475361,10-Aug-19,Virginia,Richmond,6346 Midlothian Turnpike,0,4,4
1476271,10-Aug-19,California,San Francisco,1100 Fillmore St,0,4,4
1475208,9-Aug-19,Illinois,Chicago,7300 block of S Artesian Ave,0,4,4
1472641,7-Aug-19,Missouri,Saint Louis,4900 block of Plover Ave,3,1,4
1469344,5-Aug-19,New York,Brooklyn,216 Buffalo Ave,0,4,4
1527721,4-Aug-19,Louisiana,Lake Charles,110 Pryce St,0,4,4
1468799,4-Aug-19,Tennessee,Memphis,443 E Shelby Dr,1,3,4
1459941,28-Jul-19,District of Columbia,Washington,637 T St NW,0,4,4
1460726,28-Jul-19,Illinois,Chicago,3938 W Roosevelt Rd,0,4,4
1459389,27-Jul-19,Kansas,Wichita,505 N Rock Rd,1,3,4
1459201,26-Jul-19,Washington,Kennewick,E 10th Ave,1,3,4
1453327,21-Jul-19,Illinois,Chicago,3900 block of Roosevelt Rd,0,4,4
1453884,21-Jul-19,District of Columbia,Washington,2300 block of 15th St NE,0,4,4
1453350,20-Jul-19,Maryland,Baltimore,2800 block of Boarman Ave,1,3,4
1452654,20-Jul-19,Pennsylvania,Clairton,501 Waddell Ave,0,4,4
1450767,18-Jul-19,Illinois,Chicago,3427 W Fulton Blvd,1,3,4
1450124,17-Jul-19,Texas,Lubbock,N Elder Ave and E Colgate St,1,3,4
1449602,16-Jul-19,Texas,San Antonio,6989 San Pedro Ave,0,4,4
1448578,15-Jul-19,Georgia,Atlanta,1572 Hardee St NE,0,4,4
1447456,14-Jul-19,Illinois,Chicago,4600 block of W Erie St,0,4,4
1445066,11-Jul-19,Texas,Houston,5901 Royal Palms St,0,4,4
1441967,8-Jul-19,District of Columbia,Washington,3900 Martin Luther King Jr Ave SW,2,2,4
1441396,7-Jul-19,Illinois,Chicago,5600 block of S Paulina St,0,4,4
1441296,7-Jul-19,Illinois,Chicago,600 block of W 61st Pl,0,4,4
1441317,7-Jul-19,New Mexico,Albuquerque,211 Gold Ave SW,0,4,4
1441427,6-Jul-19,California,San Jose,3036 Quinto Way,0,4,4
1440257,5-Jul-19,New York,Brooklyn,Elton St and Belmont Ave,0,4,4
1440765,4-Jul-19,Illinois,Rockford,1100 block of Preston St,0,4,4
1439737,4-Jul-19,California,Los Angeles,1900 block of Adair St,0,4,4
1438971,4-Jul-19,Illinois,Chicago,800 block of N Homan Ave,1,3,4
1439765,4-Jul-19,California,Fresno,4700 block of E Hamilton Ave,1,3,4
1438602,2-Jul-19,Missouri,Saint Louis (Wellston),6250 Page Ave,0,4,4
1437094,1-Jul-19,Maryland,Baltimore,1200 block of N Luzerne Ave,0,4,4
1435804,30-Jun-19,California,Oakland,3000 block of Brookdale Ave,0,4,4
1436254,30-Jun-19,Texas,Dallas,3535 Munger Ave,2,2,4
1435041,29-Jun-19,Connecticut,Hartford,Judson St and Martin St,0,4,4
1435297,29-Jun-19,Louisiana,Gray,2700 block of W Park Ave,0,4,4
1434882,28-Jun-19,New Jersey,Paterson,50 block of Jefferson St,0,4,4
1434893,28-Jun-19,New Jersey,Jersey City,167 Armstrong Ave,0,4,4
1432930,26-Jun-19,Ohio,Akron,900 block of Rowe St,1,3,4
1433857,26-Jun-19,Wisconsin,Milwaukee,2800 block of N 34th St,0,4,4
1429475,23-Jun-19,California,La Jolla,7500 block of Draper Ave,1,3,4
1429338,23-Jun-19,South Carolina,Abbeville,1108 Cambridge St,3,1,4
1429399,22-Jun-19,Virginia,Hampton,1st St and E Pembroke Ave,0,4,4
1429022,22-Jun-19,Pennsylvania,Philadelphia,2400 block of Moore St,0,4,4
1428788,21-Jun-19,Michigan,Saginaw,1506 N Charles St,1,3,4
1427483,21-Jun-19,Illinois,Chicago,6300 block of S King Dr,0,4,4
1425161,17-Jun-19,Texas,San Antonio,E Market St and Tower of the Americas Way,0,4,4
1422981,15-Jun-19,Louisiana,Shreveport,2500 block of Hollywood Ave,0,4,4
1420933,12-Jun-19,North Carolina,Charlotte,305 N Graham St,1,3,4
1419305,11-Jun-19,Colorado,Aurora,12500 block of E Kansas Pl,0,4,4
1420432,11-Jun-19,Georgia,Savannah,6900 Block of Damascus Rd,2,2,4
1418533,9-Jun-19,Ohio,Cleveland,17218 Tarkington Ave,1,3,4
1418548,9-Jun-19,New York,Buffalo,2081 Niagara St,0,4,4
1418457,9-Jun-19,Tennessee,Henning,265 N Main St,1,3,4
1417570,8-Jun-19,Illinois,Chicago,3500 block of W North Ave,0,4,4
1416374,6-Jun-19,Illinois,Chicago,2500 block of N Lake Shore Dr,1,3,4
1415399,5-Jun-19,California,Santa Rosa,828 W 9th Street,0,4,4
1411598,1-Jun-19,Illinois,Chicago,300 block of East Chicago Ave,0,4,4
1411408,1-Jun-19,Virginia,Portsmouth,1100 block of Mt Vernon Ave,1,3,4
1412243,1-Jun-19,Illinois,Chicago,5600 block of West Madison St,0,4,4
1411661,31-May-19,California,West Covina,306 N Hollow Ave,1,3,4
1409255,29-May-19,Louisiana,Reserve,300 block of Homewood Place,1,3,4
1407941,27-May-19,Missouri,Saint Louis,5900 block of Goodfellow Blvd,2,2,4
1405445,26-May-19,District of Columbia,Washington,3509 Wheeler Rd SE,1,3,4
1406070,26-May-19,California,Stockton,600 block of E Oak St,1,3,4
1405317,25-May-19,Maryland,Baltimore,500 block of N Belnord Ave,0,4,4
1400095,20-May-19,Oklahoma,Tulsa,8118 E 16th St,2,2,4
1400561,20-May-19,Ohio,Columbus,2424 Sullivant Ave,0,4,4
1398584,18-May-19,Iowa,Cedar Rapids,70 Kirkwood Ct SW,2,2,4
1400934,18-May-19,Nebraska,Omaha,2825 Y St,0,4,4
1398876,17-May-19,California,Sacramento,7326 Stockton Blvd,1,3,4
1397521,16-May-19,Ohio,Cleveland,9500 Cardwell Ave,0,4,4
1396491,15-May-19,Louisiana,Saint Rose,100 block of St. Rose Ave,0,4,4
1395560,14-May-19,California,Los Angeles,1248 W 47th St,0,4,4
1393960,13-May-19,Louisiana,New Orleans,2100 block of 4th St,0,4,4
1392923,11-May-19,Pennsylvania,Effort,Toll Rd and Bayberry Rd,0,4,4
1390764,8-May-19,Indiana,Indianapolis,Roache St and Rader St,0,4,4
1386929,4-May-19,Indiana,Indianapolis,101 W Maryland St,0,4,4
1386575,4-May-19,Delaware,Wilmington,W 27th St and Tatnall St,0,4,4
1386481,3-May-19,Texas,Dallas,5400 Cedar Springs Rd,1,3,4
1385642,3-May-19,Maryland,Baltimore,2500 block of E Biddle St,0,4,4
1384553,1-May-19,Massachusetts,Boston,32 Windermere Rd,1,3,4
1382099,28-Apr-19,Alabama,Birmingham,514 19th St Ensley,0,4,4
1382711,28-Apr-19,Ohio,West Chester,4637 Wyndtree Dr,4,0,4
1381771,27-Apr-19,Mississippi,Jackson,700 block of Monterey St,1,3,4
1381273,27-Apr-19,California,Poway,16934 Chabad Way,1,3,4
1377519,21-Apr-19,Pennsylvania,Philadelphia,1500 block of South 31st St,0,4,4
1376883,19-Apr-19,Kansas,Wichita,1628 S George Washington Blvd,0,4,4
1375235,18-Apr-19,Kentucky,Louisville,4000 block of Bells Ln,0,4,4
1373557,16-Apr-19,Maryland,Germantown,18700 block of Curry Powder Ln,1,3,4
1370795,14-Apr-19,Florida,Miami,NW 19th Ave and 60th St,2,2,4
1371024,14-Apr-19,California,Vallejo,100 block of Princeton Ave,1,3,4
1371065,14-Apr-19,California,Stockton,2539 E Main St,0,4,4
1374920,13-Apr-19,California,Moreno Valley,23500 block of Alessandro Blvd,0,4,4
1370269,12-Apr-19,Illinois,Carbondale,119 N Washington St,0,4,4
1368597,11-Apr-19,Maryland,Baltimore,2200 block of Ruskin Ave,1,3,4
1367011,9-Apr-19,Missouri,Kansas City,5339 Michigan Ave,1,3,4
1365077,7-Apr-19,Indiana,Indianapolis,3600 block of Roosevelt Ave,2,2,4
1365100,7-Apr-19,Louisiana,Shreveport,433 Flournoy Lucas Rd,0,4,4
1364443,6-Apr-19,Florida,Tallahassee,500 block of Kissimmee St,0,4,4
1363737,4-Apr-19,Florida,Panama City,100 block of Allen Ave,1,3,4
1362364,2-Apr-19,Mississippi,Hermanville,13195 MS 18,0,4,4
1357591,28-Mar-19,Maryland,Baltimore,6200 block of Boston St,0,4,4
1348844,17-Mar-19,Georgia,Augusta,900 block of Broad St,0,4,4
1349256,17-Mar-19,Georgia,Rochelle,Dennis St,1,3,4
1348793,17-Mar-19,Nevada,Las Vegas,600 E Fremont St,0,4,4
1347974,16-Mar-19,New Jersey,Camden,619 Ferry Ave,1,3,4
1347894,14-Mar-19,Montana,Missoula,5145 Airway Blvd,1,3,4
1344488,11-Mar-19,New Jersey,Paterson,291 12th Ave,0,4,4
1343330,10-Mar-19,Louisiana,Shreveport,2700 block of San Jacinto Ave,0,4,4
1338860,3-Mar-19,California,Oakland,316 14th St,0,4,4
1337498,28-Feb-19,California,Oakland,9755 Edes Ave,1,3,4
1333480,22-Feb-19,Alabama,Birmingham,1100 block of Carnation Dr,2,2,4
1332507,21-Feb-19,Kentucky,Elizabethtown,600 N Miles St,2,2,4
1332429,21-Feb-19,Texas,Houston,12800 block of Eastbrook Dr,2,2,4
1332181,20-Feb-19,Tennessee,Covington,529 N College St,0,4,4
1329144,17-Feb-19,Texas,Henderson,504 S Van Buren St,2,2,4
1323448,9-Feb-19,Virginia,Petersburg,109 Perry St,0,4,4
1321021,6-Feb-19,New York,Brooklyn,1778 Fulton St,1,3,4
1321093,5-Feb-19,Texas,San Antonio,538 Hot Wells Blvd,2,2,4
1319325,4-Feb-19,Louisiana,Baton Rouge,4000 block of Topeka St,0,4,4
1320286,3-Feb-19,California,Palm Springs,E Sunny Dunes Rd and El Placer Rd,4,0,4
1318187,1-Feb-19,California,San Diego,6800 block of Springfield St,0,4,4
1312391,26-Jan-19,Georgia,Albany,300 block of W Roosevelt,0,4,4
1313291,26-Jan-19,New Jersey,Newark,612 Bergen St,1,3,4
1306920,20-Jan-19,Florida,Miami,26133 SW 139th Ave,0,4,4
1305563,19-Jan-19,Pennsylvania,Lebanon,1140 Church St,0,4,4
1305516,19-Jan-19,Illinois,Chicago,4400 block of W Madison St,0,4,4
1303486,17-Jan-19,Kentucky,Owensboro,940 Audubon Ave,3,1,4
1303303,16-Jan-19,California,Palmdale,Ranch Center Dr and 40th St W,3,1,4
1295294,6-Jan-19,New Mexico,Roswell,1300 block of W College Blvd,0,4,4
1292941,3-Jan-19,Arizona,Yuma,3800 block of E County 18Â½ St,1,3,4
1291779,2-Jan-19,Arkansas,Jonesboro,3516 Galaxy St,1,3,4
1288376,29-Dec-18,Ohio,Lima,904 S Main St,1,3,4
1284586,24-Dec-18,Louisiana,Lutcher,2176 Main St,2,2,4
1282704,22-Dec-18,Nevada,Las Vegas,3528 S Maryland Pkwy,0,4,4
1277411,14-Dec-18,Colorado,Colorado Springs,700 block of Geiger Ct,1,3,4
1276091,13-Dec-18,Pennsylvania,Philadelphia,4505 N Broad St,0,4,4
1276298,11-Dec-18,Louisiana,Natchitoches,Caspari St and University Pkwy,1,3,4
1272855,9-Dec-18,Wisconsin,Madison,3554 E Washington Ave,0,4,4
1266937,26-Nov-18,Tennessee,Powell,Tammy Dr,0,4,4
1262814,25-Nov-18,Alabama,Demopolis,Floyd St and Field St,2,2,4
1263332,25-Nov-18,California,Oakland,1000 block of 24th St,0,4,4
1263086,25-Nov-18,Texas,Houston,4500 block of Yale St,1,3,4
1260525,21-Nov-18,Missouri,Saint Louis,4200 block of Shreve Ave,0,4,4
1258804,19-Nov-18,Pennsylvania,Philadelphia,5100 block of Malcolm St,4,0,4
1257508,16-Nov-18,Arkansas,Little Rock,4405 W 14th St,3,1,4
1256435,14-Nov-18,Louisiana,Baton Rouge,4896 Gus Young Ave,3,1,4
1254084,12-Nov-18,North Carolina,Dunn,4640 Woods Crossroads Rd,3,1,4
1253361,11-Nov-18,Arizona,Globe,598 N Broad St,3,1,4
1247019,2-Nov-18,California,Long Beach (North Long Beach),5800 block of Brayton Ave,0,4,4
1244754,31-Oct-18,Michigan,Detroit,19000 block of Langholm St,1,3,4
1243010,28-Oct-18,Arkansas,El Dorado,2 Whites Quarters,2,2,4
1242443,26-Oct-18,New Jersey,Jersey City,77 Brinkerhoff St,1,3,4
1238052,21-Oct-18,Washington,Lakewood,8722 S Tacoma Way,1,3,4
1234087,16-Oct-18,Georgia,Atlanta,Broad St,0,4,4
1232554,14-Oct-18,Texas,Fort Worth,5310 E Rosedale St,0,4,4
1233563,14-Oct-18,Nevada,Las Vegas,2815 W Lake Mead Blvd,3,1,4
1233068,14-Oct-18,California,Palo Alto (East Palo Alto),2500 block of Pulgas Ave,2,2,4
1232018,13-Oct-18,Missouri,Saint Louis,400 block of Midlothian Road,0,4,4
1231385,12-Oct-18,Nevada,Las Vegas,6500 block of W Charleston Blvd,0,4,4
1229738,8-Oct-18,Alabama,Birmingham,Joppa Ave,0,4,4
1226923,6-Oct-18,Oklahoma,Tulsa,9453 E 31st St,0,4,4
1226853,6-Oct-18,Texas,Houston,6802 Cullen Blvd,1,3,4
1225631,4-Oct-18,Georgia,Swainsboro,Lucky St,0,4,4
1226179,4-Oct-18,New Mexico,Espanola (EspaÃ±ola),1813 N Riverside Dr,1,3,4
1221758,1-Oct-18,Illinois,Chicago,500 block of S Michigan Ave,2,2,4
1221794,30-Sep-18,California,Compton,1300 E Palmer St,1,3,4
1220331,28-Sep-18,Pennsylvania,Philadelphia,5100 block of Haverford Ave,2,2,4
1215954,23-Sep-18,California,Baldwin Park,3700 block of Loma Lane,0,4,4
1215904,22-Sep-18,New York,Hempstead,Dolan St,0,4,4
1215739,21-Sep-18,District of Columbia,Washington,1800 block of Benning Rd NE,0,4,4
1213836,19-Sep-18,Illinois,Chicago,W Cermak Rd and S State St,0,4,4
1212984,18-Sep-18,Louisiana,New Orleans (Algiers),1100 block of Sumner St,0,4,4
1212567,18-Sep-18,Tennessee,Memphis,4622 Faronia Rd,0,4,4
1210742,15-Sep-18,Wisconsin,Milwaukee,820 S 21st St,0,4,4
1208397,11-Sep-18,Illinois,Chicago,10600 block of S Bensley Avenue,0,4,4
1206409,9-Sep-18,Illinois,Elgin,550 S McLean Blvd,1,3,4
1206476,9-Sep-18,Florida,Jacksonville,N/A,0,4,4
1206050,7-Sep-18,Minnesota,Minneapolis,2024 N Washington Ave,1,3,4
1204486,4-Sep-18,Georgia,Albany,1200 block of Gillespie Ave,0,4,4
1202134,2-Sep-18,Texas,San Antonio,600 block of Morningview St,0,4,4
1202274,2-Sep-18,New Jersey,Paterson,43 12th Ave,2,2,4
1201885,2-Sep-18,Arkansas,Fort Smith,801 Garrison Ave,0,4,4
1202437,2-Sep-18,New Jersey,Trenton,Stuyvesant Ave and Bryn Mawr Ave,0,4,4
1201973,1-Sep-18,Florida,Fort Lauderdale (Lauderhill),5225 NW 24th Ct,1,3,4
1197278,27-Aug-18,Arkansas,Pine Bluff,2600 block of W 34th Ave,1,3,4
1194315,23-Aug-18,Pennsylvania,Philadelphia,5800 block of Oakland St,0,4,4
1194598,23-Aug-18,Maryland,Baltimore,1700 block of Homestead St,0,4,4
1194057,22-Aug-18,Missouri,Saint Louis,I-64 and Jefferson Ave,0,4,4
1192788,21-Aug-18,Tennessee,Memphis,2119 E Alcy Rd,0,4,4
1192036,20-Aug-18,Ohio,Cleveland,E 94th St and Kinsman Rd,1,3,4
1190035,18-Aug-18,New York,Bronx,925 Allerton Ave,0,4,4
1185622,12-Aug-18,Pennsylvania,Pittsburgh (East Liberty),5600 block of Broad St,0,4,4
1184607,11-Aug-18,Colorado,Thornton,4050 E 100th Ave,1,3,4
1185040,11-Aug-18,Ohio,Columbus,1280 Summit St,0,4,4
1184992,10-Aug-18,Missouri,Saint Louis,1515 N 13th St,0,4,4
1184206,10-Aug-18,Michigan,Detroit,6300 block of Vinewood St,0,4,4
1182893,8-Aug-18,New Jersey,Paterson,Mercer St and Franklin St,0,4,4
1179677,5-Aug-18,Illinois,Chicago,900 block of S Karlov Ave,0,4,4
1179644,5-Aug-18,Illinois,Chicago,1600 block of S Avers Ave,0,4,4
1179805,4-Aug-18,Illinois,Chicago,1600 block of N Leclaire Ave,1,3,4
1179589,4-Aug-18,Wisconsin,Milwaukee,40th St and Vliet St,0,4,4
1177024,30-Jul-18,Georgia,Savannah,12328 Largo Dr,0,4,4
1175571,30-Jul-18,Illinois,Chicago,1200 block of S Avers Ave,0,4,4
1174423,29-Jul-18,Pennsylvania,York,100 block of E Maple St,0,4,4
1174990,29-Jul-18,Michigan,Lansing,Spring and River Street,0,4,4
1173637,27-Jul-18,Illinois,Chicago,1100 block of S Troy St,0,4,4
1173069,26-Jul-18,California,Oakland,73rd Ave and Bancroft Ave,2,2,4
1172333,25-Jul-18,Louisiana,New Orleans,7000 block of Bullard Ave,0,4,4
1168828,21-Jul-18,Maryland,Baltimore,1000 block of Dundalk Ave,0,4,4
1167806,20-Jul-18,New Jersey,Elizabeth,323 Irvington Ave,0,4,4
1166302,18-Jul-18,Oklahoma,Oklahoma City,7201 Melrose Ln,0,4,4
1164167,15-Jul-18,Colorado,Denver,50th Ave and Grant St,0,4,4
1163947,14-Jul-18,Maryland,Fort Washington,9500 block of Fort Foote Rd,0,4,4
1162785,13-Jul-18,Virginia,Richmond,1401 Roseneath Rd,1,3,4
1162437,11-Jul-18,Texas,Houston,9550 Bissonnet St,0,4,4
1161230,11-Jul-18,Florida,Reddick,16300 block of NW Gainesville Rd,0,4,4
1159528,8-Jul-18,Tennessee,Memphis,Mount Moriah Rd and Mendenhall Rd,0,4,4
1156480,5-Jul-18,New York,Brooklyn,280 Herkimer St,0,4,4
1157073,5-Jul-18,New York,Albany,First St and Lexington Ave,0,4,4
1155906,4-Jul-18,Georgia,Atlanta,5456 E Fayetteville Rd,1,3,4
1154998,3-Jul-18,District of Columbia,Washington,1700 block of Benning Rd NE,0,4,4
1154558,2-Jul-18,New York,Buffalo,Grape St,2,2,4
1151355,27-Jun-18,California,Oakland,8901 MacArthur Boulevard,1,3,4
1151527,27-Jun-18,Texas,San Antonio,100 block of Holly Street,0,4,4
1151373,27-Jun-18,Connecticut,Hartford,124 Hillside Ave,0,4,4
1148678,24-Jun-18,Florida,Punta Gorda,2450 Harbour Dr,0,4,4
1148647,24-Jun-18,Florida,Indiantown,17068 SW Palm Beach St,0,4,4
1149173,24-Jun-18,Florida,Palm Beach Gardens (Riviera Beach),1200 block of W 35th St,1,3,4
1149463,24-Jun-18,Indiana,Gary,2500 block of Harrison Street,1,3,4
1148042,23-Jun-18,Kansas,Wichita,1403 Harding  St,0,4,4
1161366,23-Jun-18,Tennessee,Covington,319 N High St,0,4,4
1147323,22-Jun-18,Pennsylvania,Homestead (Munhall),1324 Margaret St,1,3,4
1146968,21-Jun-18,California,San Bernardino,279 W Base Line,1,3,4
1146760,21-Jun-18,Louisiana,Morganza,Deaton Ln,0,4,4
1146547,21-Jun-18,Illinois,Chicago,6500 block of S Claremont Ave,0,4,4
1145881,19-Jun-18,Alabama,Huntsville,905 Lee Dr NW,0,4,4
1144852,18-Jun-18,Illinois,Bloomington,311 Riley Dr,3,1,4
1143135,17-Jun-18,North Carolina,Charlotte,3215 Queen City Dr,0,4,4
1143081,17-Jun-18,Georgia,Macon,325 Edgewood Ln,1,3,4
1143524,17-Jun-18,Illinois,Chicago,2200 block of S Sacramento Ave,0,4,4
1141108,14-Jun-18,Colorado,Westminster,5150 W 80th Ave,1,3,4
1142145,14-Jun-18,Pennsylvania,Philadelphia,400 block of Penn St,0,4,4
1139320,12-Jun-18,New York,Bronx,W 166th St and  Summit Ave,0,4,4
1139176,11-Jun-18,Alabama,Montgomery,3220 block of Virginia Pines Ln,0,4,4
1137848,10-Jun-18,Illinois,Bloomington,1200 block of Orchard Rd,2,2,4
1137737,9-Jun-18,North Carolina,Kannapolis,1709 S Cannon Blvd,0,4,4
1136928,9-Jun-18,Massachusetts,Boston,14 Copeland St,0,4,4
1134378,5-Jun-18,Florida,Jacksonville,Town Center Pkwy,3,1,4
1131909,3-Jun-18,Illinois,Chicago,1200 block of W 73rd Pl,1,3,4
1126712,27-May-18,Louisiana,Shreveport,857 E Stoner Ave,0,4,4
1126434,27-May-18,Colorado,Aurora,15373 E 6th Ave,1,3,4
1124777,25-May-18,Ohio,Cincinnati,1000 block of Ross Avenue,0,4,4
1122728,20-May-18,Indiana,Anderson,1604 Madison Ave,0,4,4
1115110,14-May-18,Maryland,Baltimore,2020 Etting St,0,4,4
1114725,13-May-18,California,Los Angeles,365 W Manchester Avenue,2,2,4
1114402,13-May-18,Mississippi,Byhalia,French Rd and Berta Rd,0,4,4
1113538,12-May-18,New Jersey,Paulsboro,275 W Buck St,0,4,4
1113737,11-May-18,Missouri,Saint Louis,4800 block of Farlin Ave,0,4,4
1111950,9-May-18,Missouri,Saint Louis,5200 block of Minerva Avenue,0,4,4
1111649,9-May-18,Nebraska,Omaha,Sahler St and N 48th St,0,4,4
1108856,6-May-18,Oklahoma,Stillwater,2020 East Lakeview Road,0,4,4
1110773,4-May-18,North Carolina,Henderson,519 Hilliard St,0,4,4
1109928,4-May-18,Illinois,Chicago Heights,200 block of E 23rd St,0,4,4
1103454,30-Apr-18,Florida,Pompano Beach,4251 N Dixie Hwy,0,4,4
1103465,30-Apr-18,District of Columbia,Washington,3600 block of New York Ave NE,0,4,4
1103423,29-Apr-18,Tennessee,Wartburg,519 South Kingston St,0,4,4
1102808,29-Apr-18,Washington,Seattle (Skyway),12603 Renton Ave S,2,2,4
1103045,29-Apr-18,North Carolina,Monroe,1500 block of Massey St,1,3,4
1102900,29-Apr-18,Florida,West Palm Beach,1969 S Military Trail,1,3,4
1100691,25-Apr-18,Arkansas,Pine Bluff,300 block of West 24th Street,0,4,4
1100852,25-Apr-18,Missouri,Saint Louis,1151 Northdale Dr,3,1,4
1099516,24-Apr-18,Michigan,Flint,2200 block of Ave A,0,4,4
1096232,21-Apr-18,Pennsylvania,Philadelphia,1800 block of W Diamond St,2,2,4
1088778,9-Apr-18,California,Vallejo,201 Maine St,0,4,4
1087153,8-Apr-18,North Carolina,Hickory,247 1st Ave NW,1,3,4
1087021,8-Apr-18,Florida,Miami,1300 block of NW 63rd Terrace,2,2,4
1086773,6-Apr-18,Florida,Jacksonville,6100 block of Transylvania Ave,0,4,4
1086966,6-Apr-18,Virginia,Virginia Beach,5800 block of Pickering St,1,3,4
1084847,4-Apr-18,Louisiana,New Orleans,3300 Garden Oaks Drive,2,2,4
1083552,2-Apr-18,Texas,Houston,8500 block of Redcliff Rd,1,3,4
1080234,29-Mar-18,Texas,Plano,7401 Alma Dr,1,3,4
1080442,29-Mar-18,New Jersey,Camden,Kaighn Ave and Haddon Ave,0,4,4
1077180,24-Mar-18,Utah,Salt Lake City (West Valley City),3180 South 5600 West,0,4,4
1071381,17-Mar-18,Illinois,Harvey,16700 S Halsted St,0,4,4
1078612,13-Mar-18,Florida,Macclenny,South Blvd,0,4,4
1068615,12-Mar-18,California,Modesto,2000 block of Robertson Rd,0,4,4
1067264,11-Mar-18,Illinois,Champaign,700 block of N Hickory St,1,3,4
1066594,9-Mar-18,North Carolina,Wadesboro,1300 E Caswell St,3,1,4
1064514,7-Mar-18,Alabama,Hurtsboro,531 Main Street,2,2,4
1061748,3-Mar-18,New York,Brooklyn,Kings Highway and Utica Avenue,1,3,4
1062123,3-Mar-18,Florida,Miami,1300 Block of NW 62nd Ln,0,4,4
1059559,27-Feb-18,Connecticut,Bridgeport,1306 Stratford Ave,0,4,4
1056240,23-Feb-18,Florida,Palm Beach Gardens (Riviera Beach),W 23rd St,1,3,4
1051291,16-Feb-18,Oklahoma,Oklahoma City,1700 block of SW 15,1,3,4
1040815,31-Jan-18,Missouri,Saint Louis,Goodfellow Blvd and Dr Martin Luther King Dr,0,4,4
1038429,28-Jan-18,Pennsylvania,Reading,123 S 3rd St,4,0,4
1037438,27-Jan-18,Kentucky,Bowling Green,645 Pearl Street,0,4,4
1035803,25-Jan-18,District of Columbia,Washington,1600 block of Kenilworth Ave NE,0,4,4
1034205,23-Jan-18,Pennsylvania,Philadelphia,N 24th St and Ridge Ave,0,4,4
1032393,21-Jan-18,Florida,Orlando,3101 Willow Bend Blvd,0,4,4
1031851,21-Jan-18,Illinois,Chicago,3200 W Division St,0,4,4
1029095,17-Jan-18,District of Columbia,Washington,2000 block of 16th St SE,1,3,4
1027013,14-Jan-18,Alabama,Madison,101 Westchester Dr,0,4,4
1025272,11-Jan-18,Missouri,Saint Robert (St Robert),St Robert Outer Road and Houston Road,2,2,4
1022055,7-Jan-18,Florida,Plantation,5225 W Broward Blvd,0,4,4
1020574,4-Jan-18,Arkansas,Brinkley,615 W 6th St,1,3,4
1018295,1-Jan-18,Alabama,Huntsville,2025 Sparkman Dr NW,1,3,4
1017422,31-Dec-17,Illinois,Chicago,2335 Howard St,0,4,4
1018118,31-Dec-17,New Jersey,Long Branch,635 Wall St,4,0,4
1015666,27-Dec-17,Nevada,Las Vegas,3750 E Bonanza Rd,2,2,4
1014971,23-Dec-17,Louisiana,Eunice,100 block of City Avenue,1,3,4
1013377,23-Dec-17,Alabama,Birmingham,3rd Ave N and 9th St N,0,4,4
1011953,21-Dec-17,Pennsylvania,Philadelphia,6600 block of Dorel St,1,3,4
1012704,21-Dec-17,Louisiana,Lafayette,1500 block of N University Avenue,0,4,4
1009629,16-Dec-17,Mississippi,Mc Cool (Mccool),Ferguson Rd,0,4,4
1007054,13-Dec-17,Ohio,Columbus,200 block of E Barthman Ave,1,3,4
1006150,12-Dec-17,Kentucky,Louisville,17th and Gallagher Streets,0,4,4
1006446,12-Dec-17,Texas,Garland,1301 Rivercrest Ln,0,4,4
1004454,9-Dec-17,Massachusetts,Boston,Proctor St,0,4,4
1002514,6-Dec-17,Illinois,Chicago,4620 N Broadway,0,4,4
1001566,4-Dec-17,Pennsylvania,Pittsburgh,7200 block of Everton St,2,2,4
1000479,3-Dec-17,Tennessee,Memphis,656 Marshall Ave,1,3,4
999969,2-Dec-17,Michigan,Detroit,5200 Woodward Avenue,0,4,4
991017,18-Nov-17,Minnesota,Minneapolis,3600 block of N Emerson Ave,0,4,4
990974,17-Nov-17,Louisiana,New Iberia,900 Block of Mississippi St,0,4,4
988824,14-Nov-17,California,Richmond,900 Block of View Dr,2,2,4
986816,12-Nov-17,Georgia,Atlanta,50 Lower Alabama St,2,2,4
985582,11-Nov-17,Texas,Dallas,2532 Martin Luther King Jr Blvd,1,3,4
984822,10-Nov-17,Ohio,Dayton (Trotwood),193 Olive Rd,0,4,4
984455,9-Nov-17,Pennsylvania,Philadelphia,1800 block of Ringgold,0,4,4
980269,4-Nov-17,Texas,Austin,N Lamar Blvd and Masterson Pass,0,4,4
980192,4-Nov-17,Ohio,Youngstown,2810 Market St,0,4,4
980060,4-Nov-17,California,Santa Monica,1515 Ocean Avenue,1,3,4
979651,3-Nov-17,Minnesota,Minneapolis,10th Ave S and E 24th St,0,4,4
980258,3-Nov-17,California,Gardena,E 163rd St and S Main St,0,4,4
980004,3-Nov-17,New York,Buffalo,147 Roosevelt Ave,0,4,4
975600,29-Oct-17,Texas,Austin,5500 block of Ave F,1,3,4
975817,28-Oct-17,Ohio,Toledo,1327 N Huron St,0,4,4
974704,28-Oct-17,Virginia,Petersburg,N Sycamore St and Franklin,1,3,4
974411,27-Oct-17,California,San Francisco,1100 block of Fillmore,0,4,4
966153,22-Oct-17,Connecticut,Hartford,Wethersfield Avenue and Elliott Street,0,4,4
965066,21-Oct-17,Florida,Tampa,400 block of E Nordica St,0,4,4
965077,21-Oct-17,Florida,Jacksonville,164 E Eubanks St,0,4,4
965756,21-Oct-17,Tennessee,Nashville,1277 12th Ave S,0,4,4
965251,21-Oct-17,Pennsylvania,Chester,1200 block of W Carlas Ln,0,4,4
962155,17-Oct-17,New York,Brooklyn,181 Martense St,0,4,4
962623,16-Oct-17,Mississippi,Meridian,5th Street,1,3,4
960036,15-Oct-17,Texas,Houston,6233 Gulfton St,2,2,4
959126,15-Oct-17,Arizona,Phoenix,107th Ave and Camelback Rd,1,3,4
957980,12-Oct-17,California,Aliso Viejo,6 Asbury Ct,2,2,4
957562,11-Oct-17,Ohio,Pedro,15497 SR 93,4,0,4
956942,10-Oct-17,California,San Francisco,25th St and Treat Ave,0,4,4
954428,7-Oct-17,Arizona,Phoenix,87th Ave and Thomas Rd,0,4,4
952720,5-Oct-17,Arizona,Casa Grande,400 block of W 13th Street,4,0,4
952220,3-Oct-17,Florida,Miami,2051 NW 65th St,0,4,4
946138,30-Sep-17,Tennessee,Memphis,800 block of Kerr Avenue,1,3,4
944448,28-Sep-17,Louisiana,New Orleans,2001 N Rocheblave St,1,3,4
942628,26-Sep-17,Pennsylvania,Philadelphia,100 block of Pastorius St,1,3,4
942522,26-Sep-17,Tennessee,Memphis,2531 Chelsea Ave,0,4,4
942830,26-Sep-17,Maryland,Baltimore,3200 block of Lyndale Ave,2,2,4
941144,24-Sep-17,Maryland,Baltimore,500 block of E. Patapsco Avenue,0,4,4
940644,24-Sep-17,New York,Syracuse,1226 E Fayette St,0,4,4
1974755,24-Sep-17,Pennsylvania,Philadelphia,3400 block of H St,0,4,4
941257,24-Sep-17,New Jersey,Mays Landing,6000 block of Hoover Dr,1,3,4
940142,23-Sep-17,Connecticut,Hartford,1164 Albany Ave,2,2,4
936028,17-Sep-17,Michigan,Detroit,5000 block of Stanton Street,1,3,4
933957,15-Sep-17,Illinois,Chicago,4700 block of S Fairfield Ave,4,0,4
932181,13-Sep-17,Washington,Rockford,14626 S Jackson Rd,1,3,4
932906,13-Sep-17,Pennsylvania,York,400 block of S Duke St,0,4,4
932619,13-Sep-17,Pennsylvania,Philadelphia,3100 block of N 2nd St,0,4,4
930266,10-Sep-17,Louisiana,New Orleans,2101 N Claiborne Ave,1,3,4
931139,9-Sep-17,Alabama,Selma,Kings Bend Road,0,4,4
928380,6-Sep-17,Illinois,Chicago,2700 block of Madison,0,4,4
927277,4-Sep-17,Illinois,Bellwood,1000 block of Bellwood Ave,0,4,4
925809,2-Sep-17,Kentucky,Louisville,8008 Watterson Trl,0,4,4
925436,2-Sep-17,Illinois,Chicago,8300 block of S Hermitage,1,3,4
921653,27-Aug-17,Indiana,Evansville,1127 Chestnut St,1,3,4
921289,25-Aug-17,Florida,Gainesville,1600 NE 8th Ave,0,4,4
920513,24-Aug-17,Missouri,Saint Louis,10400 block of Balmoral Dr,4,0,4
918204,22-Aug-17,Illinois,Chicago,300 block of N Central Ave,0,4,4
917793,21-Aug-17,New Jersey,Newark,Fabyan Place,0,4,4
918061,21-Aug-17,New Jersey,Newark,700 block of S 19th St,1,3,4
917820,21-Aug-17,North Carolina,Whitakers,980 Fishing Creek Rd,4,0,4
917713,21-Aug-17,Maryland,Baltimore,Cottage Avenue and Park Heights Avenue,1,3,4
917838,21-Aug-17,Tennessee,Memphis,262 Decatur St,0,4,4
916808,20-Aug-17,New York,Brooklyn,100th St and Ave M,0,4,4
914819,16-Aug-17,New York,Wyandanch,Merritt Ave and 15th St,0,4,4
913924,14-Aug-17,California,North Hollywood,Morrison St and Klump Ave,2,2,4
912322,13-Aug-17,California,Sacramento,4000 Block of Martin Luther King Jr Blvd,0,4,4
912375,13-Aug-17,Virginia,Suffolk,8700 block of Quay Rd,0,4,4
912093,12-Aug-17,Missouri,Saint Louis,12310 Bellefontaine Rd,1,3,4
907546,6-Aug-17,New York,Bronx,Unionport Rd,0,4,4
907247,5-Aug-17,New Jersey,Lakewood,900 block of Brook Road,0,4,4
907611,5-Aug-17,South Carolina,Allendale,300 block of Ellis St,1,3,4
906568,5-Aug-17,Florida,Tallahassee,1939 W Tennessee St,1,3,4
906126,3-Aug-17,District of Columbia,Washington,3426 18th St NE,1,3,4
904329,2-Aug-17,Maryland,Baltimore,900 block of N Broadway,0,4,4
903853,1-Aug-17,Illinois,Chicago,800 block of N Monticello Ave,0,4,4
903090,31-Jul-17,Illinois,Decatur,Jasper St and Main St,0,4,4
902187,30-Jul-17,Texas,El Paso,1810 George Dieter Dr,1,3,4
900963,28-Jul-17,Delaware,Wilmington,400 block of N Washington St,0,4,4
898448,25-Jul-17,Florida,Jacksonville,1040 Golfair Boulevard,1,3,4
896444,23-Jul-17,Illinois,Chicago,1500 block of East 82nd St,1,3,4
896889,23-Jul-17,Louisiana,Baton Rouge,10360 Ave H,0,4,4
894504,19-Jul-17,California,Los Angeles,Imperial Hwy and Broadway,1,3,4
893726,18-Jul-17,Wisconsin,Milwaukee,3000 block of N 39th St,0,4,4
893712,18-Jul-17,New Jersey,Trenton,Hewitt St and Division St,1,3,4
893752,18-Jul-17,Arizona,El Mirage,NW Grand Ave and W Thunderbird Rd,0,4,4
891291,15-Jul-17,Pennsylvania,Philadelphia,21st and Fitzwater,1,3,4
891092,15-Jul-17,Illinois,Chicago,12200 block of S Throop St,0,4,4
886002,8-Jul-17,Illinois,Alton,700 block of Oakwood Ave,0,4,4
884764,6-Jul-17,Mississippi,Meridian,Eighth Ave,0,4,4
883052,5-Jul-17,Georgia,Savannah,Jefferson Street and West St. Julian Street,0,4,4
883282,5-Jul-17,Illinois,Chicago (Roseland),11000 block of S Eberhart,2,2,4
882665,4-Jul-17,Florida,Orlando (Pine Castle),501 W Lancaster Rd,0,4,4
883489,4-Jul-17,North Carolina,Raleigh,105 E South St,1,3,4
881921,3-Jul-17,Michigan,Pontiac,50 block of Thorpe St,1,3,4
881700,2-Jul-17,New Jersey,Jersey City,Wilkinson Avenue,0,4,4
880738,2-Jul-17,South Carolina,Greenwood,SC 72 Bypass,0,4,4
883656,1-Jul-17,Illinois,Momence,2727 S 13000 Rd E,0,4,4
880808,1-Jul-17,New Jersey,Newark,Lincoln Park and Pennsylvania Avenue,2,2,4
880813,1-Jul-17,California,Oakland,3200 Humboldt Ave,0,4,4
876010,25-Jun-17,District of Columbia,Washington,5900 block of Southern Ave SE,0,4,4
875886,25-Jun-17,Missouri,Saint Louis,5000 block of Thekla Ave,1,3,4
876076,24-Jun-17,New Jersey,Willingboro,Pastoral Lane,0,4,4
870222,18-Jun-17,District of Columbia,Washington,3100 block of Buena Vista Terrace SE,0,4,4
869877,18-Jun-17,Illinois,Chicago,3300 block of W Crystal St,0,4,4
869838,17-Jun-17,Illinois,Chicago,50 block of N Latrobe Ave,0,4,4
868042,15-Jun-17,Virginia,Richmond,4053 Old Brook Road,1,3,4
868147,14-Jun-17,Ohio,Canton,14th St NE and Gibbs Ave NE,0,4,4
866412,13-Jun-17,Maryland,Baltimore,3300 block of Ayrdale Avenue,0,4,4
866448,13-Jun-17,Maryland,Baltimore,1200 block of Bonaparte Avenue,2,2,4
869474,13-Jun-17,Missouri,Saint Louis (University City),Ferguson Ave and Plymouth Ave,0,4,4
864852,11-Jun-17,Tennessee,Chattanooga,4272 Bonny Oaks Drive,0,4,4
865371,11-Jun-17,Texas,Houston,505 Cypress Station Dr,0,4,4
865186,10-Jun-17,Tennessee,Memphis,571 East Street,0,4,4
858810,3-Jun-17,Missouri,Saint Louis,1600 Block of Union Blvd,2,2,4
858877,2-Jun-17,California,Los Angeles,89th St and Broadway,1,3,4
857443,1-Jun-17,Missouri,Saint Louis,Beacon Ave and Lillian Ave,3,1,4
855764,30-May-17,Ohio,Middletown,1200 Elliott Dr,1,3,4
855113,29-May-17,Kentucky,Louisville,231 Witherspoon St,1,3,4
853032,27-May-17,New York,New York (Manhattan),318 W 14th St,0,4,4
852676,26-May-17,Florida,Miami,2730 NW 167th St,0,4,4
848680,21-May-17,Iowa,Des Moines,4300 Beaver Dr,1,3,4
849215,21-May-17,Arizona,Mesa,441 N Val Vista Dr,0,4,4
845364,16-May-17,South Carolina,Ruffin,21785 Lowcountry Hwy,3,1,4
843590,14-May-17,Texas,Fort Worth,8600 block of Calmont Ave,0,4,4
840339,10-May-17,New Jersey,Trenton,300 block of Centre St,1,3,4
839846,9-May-17,Kansas,Kansas City,1900 block of S. Boeke,3,1,4
835961,4-May-17,Michigan,Flint,600 block of Copeman Boulevard,1,3,4
834832,2-May-17,Florida,Jacksonville,1566 West 24th Street,1,3,4
835459,29-Apr-17,California,Los Angeles (Boyle Heights),Murchison St and Lancaster Ave,1,3,4
831667,29-Apr-17,Maryland,Germantown,12839 Kitchen House Way,1,3,4
834788,29-Apr-17,California,Compton,2000 Block of N Nestor Ave,0,4,4
832063,29-Apr-17,Virginia,Virginia Beach,200 block of 18th St,0,4,4
831201,28-Apr-17,Pennsylvania,Chester,5 E 21st St,0,4,4
830984,27-Apr-17,New Jersey,Newark,1100 block of S Orange Ave,1,3,4
829073,26-Apr-17,Florida,Miami,SW 264th St and 139th Ave,0,4,4
825694,21-Apr-17,Florida,Palm Bay,2500 block of Vernon Dr,2,2,4
825111,20-Apr-17,Kentucky,Louisville,700 block of East Jacob Street,0,4,4
821667,16-Apr-17,California,Vallejo,110 Calhoun Street,0,4,4
821723,16-Apr-17,North Carolina,Elizabeth City,611 S Martin St,0,4,4
821640,15-Apr-17,Illinois,Rock Falls,311 W  2nd St,0,4,4
821055,15-Apr-17,Pennsylvania,Philadelphia,5900 block of Hammond St,0,4,4
820565,15-Apr-17,Indiana,Indianapolis,300 block of S Meridian St,0,4,4
821651,15-Apr-17,Illinois,Harvey,14600 block of Myrtle Avenue,0,4,4
822750,15-Apr-17,California,Banning,900 block of N Allen St,0,4,4
818932,13-Apr-17,Georgia,Atlanta,30 Anderson Ave SW,1,3,4
815227,9-Apr-17,Texas,San Antonio,4000 block of Moss Spring Dr,1,3,4
815246,9-Apr-17,Indiana,Fort Wayne,9439 Lima Rd,1,3,4
813877,7-Apr-17,North Carolina,Hickory,1423 29th Ave Dr NE,3,1,4
813028,6-Apr-17,Louisiana,Lake Charles,2000 block of Tulip St,1,3,4
810756,3-Apr-17,Pennsylvania,Philadelphia,1100 block of W Stiles St,3,1,4
807618,30-Mar-17,Illinois,Chicago,2704 E 75th St,4,0,4
803689,26-Mar-17,Ohio,Cleveland,E 75th St,2,2,4
803460,25-Mar-17,Michigan,Detroit,8443 Grand River Ave,1,3,4
802837,25-Mar-17,Ohio,Cleveland,E 79th St and Woodland Ave,2,2,4
794468,15-Mar-17,Louisiana,Metairie,2508 Pasadena Ave,3,1,4
791298,10-Mar-17,Illinois,Chicago,123 E 51st St,2,2,4
791274,10-Mar-17,Louisiana,New Orleans (Gentilly),4200 block of Touro St,3,1,4
789798,7-Mar-17,Illinois,Chicago,W 76th St and S May St,0,4,4
789424,5-Mar-17,Georgia,Columbus,600 block of 32nd Street,0,4,4
787801,4-Mar-17,California,Sacramento,2500 block of 33rd St,0,4,4
786876,3-Mar-17,Pennsylvania,Philadelphia,7165 Germantown Ave,0,4,4
783963,27-Feb-17,Virginia,Newport News,11810 Fountain Way,0,4,4
780792,22-Feb-17,New York,Rochester,191 Genesee St,0,4,4
780036,21-Feb-17,Ohio,Cleveland,16700 Lorain Ave,0,4,4
779582,21-Feb-17,Mississippi,Toomsuba,Butts Road,4,0,4
778182,19-Feb-17,Virginia,Norfolk,Church Street and East Virginia Beach Blvd,1,3,4
777876,18-Feb-17,Pennsylvania,Philadelphia,50 block of N Conestoga St,0,4,4
777410,18-Feb-17,Indiana,South Bend,1000 block of Yukon St,1,3,4
775903,15-Feb-17,California,Salinas,30 Soledad Street,0,4,4
773162,12-Feb-17,New York,Newburgh,253 South William Street,1,3,4
772753,11-Feb-17,Illinois,Chicago,100 block of N Mayfield,1,3,4
772989,11-Feb-17,Tennessee,Savannah,Clifton Road and Midway Drive,0,4,4
771826,9-Feb-17,Mississippi,Jackson,3150 Robinson Road,4,0,4
769511,7-Feb-17,South Carolina,Columbia,5500 block of Fairfield Road,0,4,4
768243,6-Feb-17,Mississippi,Yazoo City,11th Street,4,0,4
765559,31-Jan-17,Tennessee,Memphis,1576 S White Station Rd,0,4,4
765153,31-Jan-17,District of Columbia,Washington,2900 block of Martin Luther King Jr Ave SE,0,4,4
764020,30-Jan-17,Minnesota,Minneapolis (Crystal),5410 Lakeland Ave N,0,4,4
1025158,27-Jan-17,Washington,Bremerton,Tenino Dr W,4,0,4
757032,22-Jan-17,Illinois,Chicago (Englewood),1800 block of W 63rd,0,4,4
757001,22-Jan-17,Georgia,Atlanta,2841 Greenbriar Pkwy SW,3,1,4
756504,21-Jan-17,Tennessee,Memphis,500 block of Delta Road,2,2,4
756015,20-Jan-17,California,Fresno,4700 block of E Montecito Ave,0,4,4
752756,16-Jan-17,Texas,Houston,8535 Martin Luther King Boulevard,0,4,4
752249,15-Jan-17,Colorado,Capulin,County Road Y,3,1,4
749769,12-Jan-17,California,Salinas,500 block of Sunrise St,2,2,4
748152,11-Jan-17,New Jersey,Newark,Hawkins Street and Christie Street,1,3,4
748348,11-Jan-17,Illinois,Chicago,4200 block of S Talman,1,3,4
745236,7-Jan-17,Michigan,Flint,2500 block of Churchill Ave,1,3,4
744799,6-Jan-17,California,Pasadena,100 block of W Claremont St,2,2,4
742542,4-Jan-17,California,Fontana,14520 Village Dr,3,1,4
742001,3-Jan-17,Texas,Allen,500 block of Hawthorne Drive,0,4,4
739451,1-Jan-17,Texas,Dallas,9220 Skillman Street,1,3,4
740447,31-Dec-16,Georgia,Lenox (El Dorado),27 Briarwood Ct,2,2,4
738749,31-Dec-16,Texas,Houston,3704 Fannin Street,1,3,4
735947,25-Dec-16,Alabama,Ozark,858 US-231,0,4,4
733176,24-Dec-16,North Carolina,Wilson,2241 Banks Lane East,4,0,4
732263,23-Dec-16,Alabama,Birmingham,3813 Richard Arrington Boulevard North,1,3,4
732574,23-Dec-16,Illinois,Chicago,4900 block of W Hubbard,0,4,4
728286,17-Dec-16,North Carolina,Charlotte,4115 N. Tryon Street,0,4,4
727555,16-Dec-16,Illinois,Chicago,13th and South Kedzie,0,4,4
727544,16-Dec-16,Illinois,Chicago,4300 block of South Rockwell,2,2,4
724667,12-Dec-16,California,Sacramento,4800 block of Myrtle Avenue,1,3,4
723649,11-Dec-16,New York,Brooklyn,192 Knickerbocker Ave,0,4,4
725338,11-Dec-16,North Carolina,Rocky Mount,1200 block of East Highland Ave,0,4,4
725323,9-Dec-16,Texas,Channelview,15300 block of Market,4,0,4
722452,9-Dec-16,California,Fresno,842 Fresno Street,0,4,4
716001,1-Dec-16,California,Clearlake Oaks,Pomo Rd,1,3,4
712796,28-Nov-16,Texas,Mission (Palmview),1840 West Palma Vista Drive,1,3,4
712776,28-Nov-16,California,Wilmington,1067 McDonald Avenue,0,4,4
713445,28-Nov-16,California,San Pedro,300 block of West 2nd Street,0,4,4
710467,25-Nov-16,Louisiana,New Orleans,Magnolia St and Felicity St,0,4,4
709276,24-Nov-16,New York,Albany,77 Central Ave,1,3,4
708777,23-Nov-16,Mississippi,Olive Branch,928 Cross Road,0,4,4
704568,18-Nov-16,Illinois,Chicago,5000 block of W Wabansia,0,4,4
699332,13-Nov-16,Texas,San Antonio,8000 Midcrown,0,4,4
699316,13-Nov-16,Florida,Orlando,Conley Street and South Ivey Lane,0,4,4
700363,12-Nov-16,Missouri,Kansas City,21st St and Cleveland Ave,1,3,4
699863,11-Nov-16,Texas,Houston,7705 Channelside Street,0,4,4
698383,10-Nov-16,Texas,Houston,6610 S Sam Houston Pkwy W,1,3,4
697377,9-Nov-16,Illinois,Chicago,3400 block of W Monroe,1,3,4
696352,9-Nov-16,Tennessee,Memphis,1800 block of East Brooks Road,0,4,4
693438,5-Nov-16,Texas,San Antonio,10726 Perrin Beitel Rd,0,4,4
693624,5-Nov-16,Florida,Fort Lauderdale (Lauderhill),3135 W Broward Blvd,1,3,4
693307,4-Nov-16,Pennsylvania,Philadelphia,5451 Springfield Ave,0,4,4
692020,3-Nov-16,Illinois,Chicago,8000 block of S Shore Dr,2,2,4
692315,3-Nov-16,New Jersey,Orange,234 Cleveland Street,2,2,4
689518,31-Oct-16,Louisiana,Shreveport,700 Block of W 68th St,0,4,4
688979,30-Oct-16,Ohio,Toledo,742 Junction Ave,0,4,4
688841,30-Oct-16,New York,New York (Manhattan),135 Ridge Street,0,4,4
687940,29-Oct-16,Ohio,Dayton,2010 Cornell Ridge Dr,1,3,4
688210,29-Oct-16,California,Riverside,3500 block of Madison Street,0,4,4
687375,28-Oct-16,Florida,Miami Gardens,Northwest 173rd Terrace and 27th Avenue,0,4,4
686312,27-Oct-16,Georgia,Jackson,600 block of Moccasin Gap Road,4,0,4
685379,25-Oct-16,Ohio,Dayton,3300 block of Riverside Dr,1,3,4
679290,18-Oct-16,California,San Francisco,325 La Grande Ave,0,4,4
675993,13-Oct-16,Illinois,Chicago,2700 block of West Lexington,0,4,4
672217,9-Oct-16,California,Sacramento,1696 Arden Way,1,3,4
671717,8-Oct-16,New York,Brooklyn,7301 3rd Ave,0,4,4
668407,3-Oct-16,Minnesota,Minneapolis,Fourth St and Hennepin Ave,0,4,4
668279,1-Oct-16,Illinois,Pembroke Township,17250E Road,4,0,4
668352,1-Oct-16,California,Fresno,3200 block of East Clay Avenue,0,4,4
665995,29-Sep-16,California,San Francisco,400 block of Ellis St,1,3,4
663624,26-Sep-16,North Carolina,Winston Salem (Winston-salem),100 block of 5 Royales Dr,0,4,4
663789,26-Sep-16,Texas,Humble,21219 Grand Linden Ct,0,4,4
662548,25-Sep-16,Illinois,Champaign,300 block of E. Green St,1,3,4
657854,18-Sep-16,Pennsylvania,Philadelphia,3001 Castor Avenue,0,4,4
658226,18-Sep-16,Pennsylvania,Pittsburgh,1700 block of Brighton Pl,0,4,4
657863,18-Sep-16,Virginia,Lynchburg,421 Rivermont Ave,1,3,4
657151,17-Sep-16,Indiana,Indianapolis,2016 West 76th Street,2,2,4
656991,16-Sep-16,California,Los Angeles (Hollywood),555 N Heliotrope Dr,2,2,4
655512,14-Sep-16,Texas,Humble,16000 block of Saybrook,1,3,4
652642,11-Sep-16,Indiana,Fort Wayne,3006 Holton Avenue,3,1,4
652759,11-Sep-16,New Jersey,Jersey City,87 Van Wagenen Ave,1,3,4
652175,10-Sep-16,Florida,Miami,3451 Northwest 36 Street,1,3,4
651957,8-Sep-16,Texas,Del Valle,8330 Linden Rd,4,0,4
648490,5-Sep-16,Pennsylvania,Reading,600 block of Moss Street,0,4,4
646995,3-Sep-16,North Carolina,Wilmington,600 block of North 30th St,1,3,4
646855,3-Sep-16,Illinois,Chicago,100 block of North Seeley Avenue,0,4,4
644723,30-Aug-16,Georgia,Atlanta,400 Merritts Avenue NE,0,4,4
643824,30-Aug-16,Illinois,Chicago (Englewood),6800 block of South Ashland,0,4,4
640677,28-Aug-16,New York,Bronx,514 E 156th St,0,4,4
640689,28-Aug-16,Missouri,Saint Louis,S Grand Blvd and Montana St,2,2,4
634889,21-Aug-16,Massachusetts,Boston,Westview and Stratton Street,0,4,4
634238,20-Aug-16,Connecticut,Hamden,903 Dixwell Ave,0,4,4
632747,18-Aug-16,Connecticut,Waterbury,402 E Main Street,0,4,4
632753,17-Aug-16,California,Oakland,Mandela Parkway,0,4,4
630007,14-Aug-16,Virginia,Norfolk,1600 block of Selden Avenue,0,4,4
629663,13-Aug-16,California,Los Angeles,6300 block of 11th Avenue,0,4,4
628570,13-Aug-16,Wisconsin,Milwaukee,4001 West Fond Du Lac Ave,2,2,4
628623,13-Aug-16,New York,Richmond Hill,Jamaica Ave and 105th St,0,4,4
628635,13-Aug-16,Missouri,Joplin,1800 Connecticut Ave,0,4,4
628178,12-Aug-16,Florida,Jacksonville,100 block of West 38th Street,1,3,4
627519,12-Aug-16,Texas,Dallas,10921 Estate Ln,1,3,4
627757,11-Aug-16,Pennsylvania,Philadelphia,500 block of E Ashmead St,0,4,4
626153,10-Aug-16,Illinois,Evanston,Foster Street and Jackson Avenue,0,4,4
626960,10-Aug-16,California,Sacramento,4000 Green Tree Drive,1,3,4
625735,8-Aug-16,New Mexico,Albuquerque,341 General Marshall Street NE,2,2,4
624156,7-Aug-16,California,Los Angeles,5925 South Figueroa Street,1,3,4
623523,7-Aug-16,Colorado,Arvada,5400 block of Sheridan Boulevard,2,2,4
624046,7-Aug-16,Mississippi,Vicksburg,4460 Clay St,1,3,4
623439,7-Aug-16,Illinois,Chicago,100 block of South Springfield,0,4,4
624057,5-Aug-16,Michigan,Pontiac,70 block of Thorpe Street,1,3,4
622500,5-Aug-16,California,Perris,21600 block of Rider St,2,2,4
621232,4-Aug-16,Tennessee,Memphis,Ayers Street and Griffith Avenue,0,4,4
620247,3-Aug-16,Georgia,Decatur,4110 Glenwood Road,1,3,4
619708,2-Aug-16,Florida,Hollywood (West Park),5700 block of Hallandale Beach Blvd,0,4,4
619408,1-Aug-16,Indiana,Evansville,South Bedford Avenue,0,4,4
617789,31-Jul-16,Florida,Miami,Southwest 203rd Terrace and 115th Avenue,3,1,4
616948,30-Jul-16,Washington,Mukilteo,10009 Chennault Beach,3,1,4
615328,28-Jul-16,Maryland,Baltimore,Greenmount Avenue,0,4,4
615024,28-Jul-16,Illinois,Chicago,800 block of West 50th Place,2,2,4
610756,23-Jul-16,South Carolina,North Charleston,3630 Ashley Phosphate Road,0,4,4
610093,23-Jul-16,Ohio,Cincinnati,3400 block of Beekman St,2,2,4
613805,23-Jul-16,New York,Brooklyn,Fountain Avenue,0,4,4
608787,20-Jul-16,California,Fresno,5100 block of E Hedges Ave,0,4,4
607265,19-Jul-16,Arkansas,West Memphis,13th Street and Tyler Avenue,0,4,4
605367,17-Jul-16,Michigan,Detroit,Grand River and McGraw avenue,0,4,4
605475,17-Jul-16,Texas,Houston,Tidwell Rd and Homestead Rd,1,3,4
605005,16-Jul-16,California,San Bernardino,1200 block of West 25th Street,0,4,4
604207,15-Jul-16,Washington,Woodland,4006 NW 417th Street,3,1,4
603475,14-Jul-16,Texas,Crosby,400 block of Pecan Avenue,3,1,4
603733,14-Jul-16,California,Oakland,1600 block of 7th Street,0,4,4
603738,14-Jul-16,Ohio,Akron,900 block of Moeller Avenue,1,3,4
602765,13-Jul-16,Missouri,Saint Louis,3000 block of Miami St,2,2,4
601119,11-Jul-16,Michigan,Jackson,500 block of Summit Avenue,0,4,4
601512,11-Jul-16,District of Columbia,Washington,5100 block of Call Pl SE,0,4,4
597366,7-Jul-16,Louisiana,Baton Rouge,2136 North Lobdell Avenue,0,4,4
595557,5-Jul-16,California,Los Angeles,56th Street and Naomi Avenue,0,4,4
595048,4-Jul-16,Pennsylvania,Pittsburgh,Seventh  Ave and Liberty Ave,0,4,4
595279,4-Jul-16,Illinois,Chicago (Englewood),5500 block of South Hermitage Avenue,0,4,4
596159,4-Jul-16,Ohio,Cleveland,1400 block of W. 107 Street,0,4,4
594480,3-Jul-16,Tennessee,Chattanooga,2300 block of Daisy Street,0,4,4
591975,28-Jun-16,California,Los Angeles,13800 block of S Avalon Boulevard,1,3,4
591294,28-Jun-16,Illinois,Chicago,1600 block of South Christiana,0,4,4
589488,27-Jun-16,Oregon,Woodburn,13436 Killiam Loop NE,3,1,4
590233,26-Jun-16,South Carolina,Bennettsville,Highway 38 N,0,4,4
589165,26-Jun-16,Texas,Houston,6000 block of Elm Street,1,3,4
588918,26-Jun-16,Texas,Corpus Christi,Baldwin Blvd  and Lamar,0,4,4
589470,25-Jun-16,Virginia,Norfolk,700 block of Craig Street,0,4,4
587983,25-Jun-16,Illinois,Chicago,1400 block of W. 114th Place,0,4,4
589046,24-Jun-16,Kansas,Kansas City,N. 3rd and Walker,0,4,4
586122,22-Jun-16,Georgia,Stone Mountain,Lancashire Cir and Central Dr,1,3,4
585821,22-Jun-16,Washington,Olympia,500 block of Dutterow Road SE,3,1,4
586058,22-Jun-16,Illinois,Chicago,3100 block of West Warren,0,4,4
586044,21-Jun-16,New Jersey,Willingboro,Mosshill Lane,0,4,4
585615,21-Jun-16,Kentucky,Louisville,2802 Rodman Street,2,2,4
583631,19-Jun-16,Virginia,Roanoke,2328 Melrose Avenue,0,4,4
583537,18-Jun-16,Georgia,Waycross,2625 Arnold Ct,2,2,4
583584,18-Jun-16,Virginia,Exmore,Frederick Douglass Rd,1,3,4
583362,18-Jun-16,Illinois,Chicago,East 79th Street and South Escanaba Avenue,0,4,4
580791,14-Jun-16,California,Oakland,1301 Franklin St,1,3,4
580848,14-Jun-16,Delaware,Wilmington,South Van Buren and Elm streets,0,4,4
579517,13-Jun-16,California,Fresno,East El Monte Way and Recreation Avenue,0,4,4
578238,11-Jun-16,Minnesota,Webster,4000 block of Elmore Avenue,0,4,4
576774,11-Jun-16,North Carolina,Charlotte,4000 block of Collegiate Avenue,1,3,4
577938,11-Jun-16,California,Stockton,Alvarado Avenue,1,3,4
575607,9-Jun-16,Florida,Fort Walton Beach,Landview Drive,0,4,4
574850,8-Jun-16,District of Columbia,Washington,1300 North Capitol St NW,0,4,4
574753,8-Jun-16,Massachusetts,Boston,66 Washington St,1,3,4
573327,6-Jun-16,California,Visalia,3360 S Fairway St,0,4,4
575061,5-Jun-16,Minnesota,Minneapolis,8th and Humboldt Avenue N.,0,4,4
572513,5-Jun-16,New York,Brooklyn,Mermaid Ave and 16th St.,0,4,4
571859,4-Jun-16,Colorado,Denver,3600 block of Hudson Street,3,1,4
569225,31-May-16,Illinois,Chicago,3300 block of West Huron Street,0,4,4
569189,31-May-16,Indiana,Fort Wayne,6600 block of Pawawna Drive,0,4,4
567788,29-May-16,Nevada,Las Vegas,200 block of N 3rd St,0,4,4
567494,29-May-16,Indiana,Indianapolis,300 block of South Meridian Street,0,4,4
563829,22-May-16,Louisiana,New Orleans,8639 Apple St,0,4,4
563514,22-May-16,California,Stockton,Poplar and Sutter Streets,1,3,4
563751,22-May-16,Tennessee,Nashville,100 block of Rains Avenue,0,4,4
563630,21-May-16,Georgia,Jackson,Levi Barnes Road,1,3,4
561912,18-May-16,Indiana,Indianapolis,34th Street and North Keystone Avenue,0,4,4
560782,17-May-16,South Carolina,Ravenel,5360 Savannah Highway,3,1,4
559194,15-May-16,Indiana,Evansville,420 North Garvin Street,0,4,4
558796,14-May-16,West Virginia,Charleston,2337 Washington St W,1,3,4
555126,8-May-16,Texas,Austin,8600 block of North Lamar,1,3,4
555886,6-May-16,Alabama,Montgomery,1300 block of Clay Street,1,3,4
554027,5-May-16,Florida,Miami,2108 NW 19th Terrace,1,3,4
550445,29-Apr-16,Missouri,Saint Louis (Ferguson),400 block of N Dade Ave,0,4,4
549507,27-Apr-16,Louisiana,Baton Rouge,4300  Block of Kerrit Dr,2,2,4
549071,27-Apr-16,Mississippi,Kilmichael,Pecan Drive,3,1,4
547639,25-Apr-16,Tennessee,Nashville,400 Charlotte Avenue,0,4,4
546818,24-Apr-16,Colorado,Denver,1400 block of 14th Street,0,4,4
546581,23-Apr-16,Nevada,Las Vegas,1650 South Hollywood Boulevard,1,3,4
546244,23-Apr-16,Alabama,Auburn,1200 block of Lee Road 83,3,1,4
546258,23-Apr-16,New York,New York (Manhattan),West 141st Street and Edgecombe Avenue,0,4,4
545501,21-Apr-16,Maryland,Baltimore,4800 block of Frankford Avenue,0,4,4
544080,19-Apr-16,Illinois,Chicago,2700 block of West 53rd Street,1,3,4
543244,18-Apr-16,California,Long Beach,1200 block of E. 17th Street,1,3,4
541996,17-Apr-16,Pennsylvania,Philadelphia,600 block of Westmoreland Street,3,1,4
543102,17-Apr-16,South Carolina,Pelzer,200 block of Eastview Road,1,3,4
542362,16-Apr-16,Alabama,Enterprise,Baxter Street,0,4,4
537825,10-Apr-16,Wisconsin,Milwaukee,76th and Sheridan,1,3,4
537820,10-Apr-16,California,Los Angeles,84th Street and Towne Avenue,0,4,4
537311,9-Apr-16,Tennessee,Memphis,Mt Moriah Road and Ridgeway Road,0,4,4
539705,9-Apr-16,Alabama,Anniston,West 15th Street and Crawford Avenue,0,4,4
537085,9-Apr-16,New Mexico,Albuquerque,2600 block of Mesa Drive SE,0,4,4
535927,7-Apr-16,Illinois,Chicago,2200 block of East 70th Place,0,4,4
532604,31-Mar-16,Illinois,Chicago (Englewood),6800 block of South Throop,0,4,4
528614,25-Mar-16,Illinois,Chicago,4500 block of West West End Avenue,0,4,4
529488,25-Mar-16,Colorado,Denver,8501 E. Alameda Avenue,0,4,4
526380,21-Mar-16,Illinois,Chicago,5700 block of West Washington Boulevard,0,4,4
525301,19-Mar-16,Alabama,Wetumpka,South Shelby Street,2,2,4
522122,13-Mar-16,Florida,Fort Myers,50 South Road,0,4,4
521821,12-Mar-16,Oregon,Portland,16126 S.E. Stark St.,0,4,4
521074,12-Mar-16,California,Oakland,I-880 and I-80,0,4,4
520767,11-Mar-16,Michigan,Detroit,2600 block of Hazelwood,2,2,4
517895,7-Mar-16,Louisiana,Lafayette,800 block of Martin Luther King Jr. Drive,0,4,4
517114,6-Mar-16,Georgia,Roswell,890 Atlanta St,0,4,4
516758,5-Mar-16,Kansas,Wichita,116 North Mead,0,4,4
516341,4-Mar-16,Ohio,Columbus,900 E 5th Ave,1,3,4
513640,28-Feb-16,California,Mira Loma,5500 block of Etiwanda Ave,1,3,4
512880,27-Feb-16,Virginia,Woodbridge (Lake Ridge),13051 Lashmere Ct,2,2,4
510769,23-Feb-16,Florida,Daytona Beach,1042 Sheridan Road,0,4,4
508879,21-Feb-16,Missouri,Hazelwood,7217 N Lindbergh Blvd,1,3,4
508341,20-Feb-16,Florida,Tampa,2810 E. Bearss Ave,1,3,4
508356,20-Feb-16,Alabama,Bessemer,200 block of Elm Street,1,3,4
508510,20-Feb-16,Florida,Orlando,446 S Parramore Ave,0,4,4
590221,19-Feb-16,Missouri,Edgerton,4100 block of Buena Vista Road,4,0,4
507998,19-Feb-16,California,Vallejo,509 Porter Street,1,3,4
504879,14-Feb-16,Texas,Houston,8449 Gulf Freeway,1,3,4
504996,13-Feb-16,Louisiana,Marrero,5425 Lapalco Boulevard,0,4,4
501349,7-Feb-16,Illinois,Chicago (Englewood),6500 block of South Green Street,0,4,4
501267,6-Feb-16,California,Los Angeles,12800 block of Cook Street,1,3,4
500629,6-Feb-16,Florida,Apopka,10th Street,0,4,4
499422,3-Feb-16,District of Columbia,Washington,1500 block of Butler St SE,0,4,4
491312,23-Jan-16,California,Los Angeles,8105 Avalon Blvd,2,2,4
486728,17-Jan-16,Virginia,Gloucester,Ditchley Dr and Gill Ln,1,3,4
481849,8-Jan-16,District of Columbia,Washington,1700 E Capitol St NE,0,4,4
481429,7-Jan-16,Tennessee,Memphis,3800 block of Kerwood Avenue,1,3,4
479613,6-Jan-16,Florida,Lakeland,2312 East Magnolia Street,3,1,4
473882,27-Dec-15,Tennessee,Jackson,North Parkway,0,4,4
472268,26-Dec-15,Pennsylvania,Philadelphia,4210 Macalester St,0,4,4
471867,25-Dec-15,Florida,Jacksonville,Franklin and Odessa,0,4,4
471860,25-Dec-15,Alabama,Mobile,785 Schillinger Rd S,0,4,4
469468,21-Dec-15,California,San Leandro,14600 block of East 14th Street,0,4,4
469614,20-Dec-15,Florida,North Miami Beach,NE 167th St and NE 6th Ave,0,4,4
464665,13-Dec-15,California,Los Angeles,5550 S. Flower Street,1,3,4
464945,13-Dec-15,California,Huntington Beach,17000 block of Keelson Lane,0,4,4
465117,12-Dec-15,Illinois,Lovejoy (Brooklyn),307 Jefferson St,1,3,4
464002,12-Dec-15,Georgia,Savannah,Whitaker Street,0,4,4
463642,11-Dec-15,Maryland,Baltimore,5100 block of Park Heights Avenue,1,3,4
463734,11-Dec-15,Pennsylvania,Pittsburgh,1222 Brownsville Rd,0,4,4
461476,8-Dec-15,Ohio,Cincinnati,2300 block of Baltimore Ave,1,3,4
460049,6-Dec-15,Louisiana,Raceland,Market Street,1,3,4
457037,2-Dec-15,Georgia,Savannah,100 block of West 33rd Street,1,3,4
455684,27-Nov-15,California,Sacramento,7900 block of Florin Road,2,2,4
454788,24-Nov-15,South Carolina,Conway,1321 Colletta Ct,0,4,4
453317,22-Nov-15,Texas,Brownsville,1800 block of FM 802,0,4,4
451338,22-Nov-15,Washington,Seattle,Broadway and Pike,0,4,4
452362,22-Nov-15,South Carolina,North Charleston,Park Circle,1,3,4
451349,22-Nov-15,Illinois,Chicago,4100 block of West Roosevelt,0,4,4
451057,21-Nov-15,Maryland,Baltimore,Stricker and School,1,3,4
450505,20-Nov-15,Pennsylvania,Pittsburgh,Prospect Drive,1,3,4
448653,16-Nov-15,Alabama,Cedar Bluff,1460 County Rd 664,3,1,4
448286,15-Nov-15,Pennsylvania,Philadelphia,5600 block of Blakemore St,0,4,4
447462,14-Nov-15,Pennsylvania,Johnstown,1159 Main St,0,4,4
444458,9-Nov-15,Indiana,Indianapolis,400 block of North Beville Ave,2,2,4
443821,8-Nov-15,Iowa,Des Moines,4397 NW 6th Drive,1,3,4
444168,8-Nov-15,Michigan,Warren,13859 8 Mile Road,0,4,4
443652,7-Nov-15,Colorado,Denver,Bayaud and Bannock,1,3,4
444406,6-Nov-15,California,Bakersfield,1000 block of Feliz Drive,0,4,4
440743,2-Nov-15,South Carolina,Pendleton,2217 Refuge Road,4,0,4
438651,28-Oct-15,Louisiana,Houma,400 block of Morgan Street,1,3,4
436219,24-Oct-15,South Carolina,Bamberg,682 Dixie Ave.,0,4,4
435144,22-Oct-15,Tennessee,Nashville,3500 John A. Merritt Blvd,1,3,4
432711,18-Oct-15,Louisiana,New Orleans,2600 block of Caffin Avenue,0,4,4
432072,17-Oct-15,Indiana,Elkhart,160 Easy Shopping Place,0,4,4
429410,12-Oct-15,Georgia,Decatur,4731 Glenwood Road,0,4,4
428247,10-Oct-15,North Carolina,Charlotte,1900 block of West Boulevard,0,4,4
429614,10-Oct-15,Illinois,Peoria,2405 N Flora,1,3,4
427621,9-Oct-15,Arizona,Flagstaff,216 E Mountain View Dr,1,3,4
422020,28-Sep-15,Ohio,Dayton,1921 Oakridge,0,4,4
421358,27-Sep-15,Illinois,Chicago,5200 block of South Justine,0,4,4
420855,27-Sep-15,Missouri,Kansas City,1700 E. 18th St.,0,4,4
426559,25-Sep-15,Illinois,Danville,1300 block of May Street,0,4,4
418964,23-Sep-15,Florida,Fort Myers,Dale St and Veronica S. Shoemaker Blvd,0,4,4
419826,23-Sep-15,Georgia,Norcross,1300 block of Reddington Lane,1,3,4
417284,20-Sep-15,Pennsylvania,Philadelphia,900 Pratt St,1,3,4
416812,19-Sep-15,Indiana,Indianapolis,3900 block of Graceland Ave,1,3,4
415687,17-Sep-15,Michigan,Albion,500 block of W. Broadwell Street,0,4,4
414580,15-Sep-15,New Jersey,Newark,Irvine Turner Boulevard and West Kinney Street,0,4,4
412996,12-Sep-15,Louisiana,Shreveport,1500 block of Clanton Street,0,4,4
412539,12-Sep-15,Minnesota,Minneapolis,1200 block of 22nd Ave. N.,1,3,4
411888,8-Sep-15,Georgia,Berlin,N/A,0,4,4
409856,8-Sep-15,Illinois,Chicago,56th and Green,0,4,4
409601,7-Sep-15,Colorado,Denver,1909 Blake Street,0,4,4
408449,5-Sep-15,North Carolina,Charlotte,6800 block of Fieldvale Place,1,3,4
408276,5-Sep-15,Florida,Daytona Beach,300 block of Pearl Street,0,4,4
409101,5-Sep-15,Nevada,Las Vegas,5000 block of Hollywood Boulevard,1,3,4
408256,5-Sep-15,Missouri,Columbia,1509 Ashley Street,0,4,4
405133,29-Aug-15,Texas,Tyler,638 ENE Loop 323,1,3,4
403069,28-Aug-15,New York,Brooklyn,589 Flatbush Avenue,1,3,4
402623,27-Aug-15,Florida,Saint Augustine,S Bellagio Dr,2,2,4
403669,27-Aug-15,California,Salinas,928 Blanco Circle,2,2,4
401884,26-Aug-15,Minnesota,Minneapolis (Brooklyn Center),5000 block of Drew Ave N,0,4,4
402113,26-Aug-15,Illinois,Chicago,3025 W. Van Buren Ave,2,2,4
402051,26-Aug-15,Florida,West Palm Beach,800 block of 19th Street,2,2,4
402108,25-Aug-15,Louisiana,New Orleans,Fern Street and Olive Street,1,3,4
399564,22-Aug-15,New Mexico,Roswell,302 East Reed Street,3,1,4
399883,22-Aug-15,Florida,Orlando,FL-408 and N Pine Hills Rd,0,4,4
395757,16-Aug-15,Illinois,Chicago,5400 block of West Division Street,0,4,4
395837,15-Aug-15,Pennsylvania,Pittsburgh,West Prospect Avenue,1,3,4
395694,15-Aug-15,California,Los Angeles,57th Street and South Normandie Avenue,0,4,4
395549,15-Aug-15,South Carolina,Orangeburg,2868 Bamberg Road,1,3,4
392131,10-Aug-15,California,Long Beach,1700 block of East 10th Street,0,4,4
391263,9-Aug-15,Mississippi,Forest,Poplar St,1,3,4
391219,9-Aug-15,Michigan,Detroit,15200 block of Hazelridge,1,3,4
391014,9-Aug-15,Missouri,Kansas City,40th Street and Pennsylvania Avenue,0,4,4
390050,7-Aug-15,Vermont,Barre,3182 Airport Rd,4,0,4
389057,6-Aug-15,South Carolina,Columbia,1505 Garden Plaza,0,4,4
401742,2-Aug-15,Illinois,Chicago,6700 block of South Winchester Avenue,0,4,4
386937,1-Aug-15,Florida,Orlando,5801 Shenandoah Way,0,4,4
384662,30-Jul-15,Pennsylvania,Pittsburgh,Brushton Avenue,0,4,4
382170,26-Jul-15,Louisiana,New Orleans,Piety and Treasure street,0,4,4
381433,25-Jul-15,Virginia,Hopewell,500 block of N. 7th Ave,0,4,4
378452,21-Jul-15,Florida,Miami Gardens,Northwest 25th Avenue and Miami Gardens Drive,1,3,4
377189,19-Jul-15,Virginia,Suffolk,100 block of North Capitol Street,0,4,4
377181,19-Jul-15,North Carolina,Rocky Mount,US-64 and E Raleigh Blvd,0,4,4
378102,18-Jul-15,California,San Diego,200 block of South Bancroft Street,0,4,4
377423,18-Jul-15,Louisiana,Baton Rouge,300 block of Brice Street,2,2,4
376823,17-Jul-15,District of Columbia,Washington,600 block of Edgewood St NE,1,3,4
376203,17-Jul-15,Ohio,Cincinnati,3100 block of Sunshine Ave,0,4,4
375322,15-Jul-15,Maryland,Baltimore,3500 block of West Garrison Boulevard,1,3,4
374965,15-Jul-15,Michigan,Detroit,9200 block of Memorial,0,4,4
374292,14-Jul-15,Missouri,Saint Louis,1100 block of Riverview,0,4,4
373993,13-Jul-15,California,Norwalk,11959 162nd Street,0,4,4
373063,12-Jul-15,New Jersey,Jersey City,Sip and Van Wagenen avenues,0,4,4
370187,7-Jul-15,Ohio,Cleveland,East 162nd Street and Miles Avenue,1,3,4
370474,7-Jul-15,Maryland,Baltimore,900 block of West Fayette Street,3,1,4
369196,5-Jul-15,New Jersey,East Orange,200 block of S. Clinton St,1,3,4
369410,4-Jul-15,Kentucky,Louisville,2500 block of West Broadway,0,4,4
368867,4-Jul-15,District of Columbia,Washington,2600 block of Douglass Pl SE,1,3,4
368995,4-Jul-15,New York,Syracuse,Bellevue and Rich Street,0,4,4
369127,4-Jul-15,Texas,San Antonio,1100 block of West Avenue,0,4,4
367780,2-Jul-15,Indiana,Indianapolis,500 block of Lynn St,1,3,4
366046,29-Jun-15,Florida,Opa Locka,13450 NW 30th Ave,0,4,4
364872,27-Jun-15,Massachusetts,Taunton,Weir Street,1,3,4
364789,27-Jun-15,Michigan,Detroit,Stringham Court,0,4,4
364210,25-Jun-15,Louisiana,New Orleans,2588 Martin Luther King Jr Blvd,0,4,4
363418,24-Jun-15,New York,New York (Manhattan),2110 Madison Ave,0,4,4
360895,20-Jun-15,North Carolina,Morven,6066 Robinson Bridge Rd,0,4,4
361014,19-Jun-15,Rhode Island,Woonsocket,80 River Street,0,4,4
359215,16-Jun-15,Florida,Miami Gardens,600 block of Northwest 177th Street,0,4,4
358117,15-Jun-15,New York,Brooklyn,673 Flatbush Avenue,0,4,4
357597,14-Jun-15,New Jersey,Camden,2800 block of Mitchell Street,1,3,4
357667,14-Jun-15,Oklahoma,Tulsa,1800 block of North Kingston,0,4,4
357611,14-Jun-15,Missouri,Saint Louis,1400 block of North Market Street,0,4,4
357590,13-Jun-15,Oklahoma,Oklahoma City,500 block of SE 69th St,0,4,4
357770,13-Jun-15,Georgia,Milledgeville,451 North Flynn Street,1,3,4
357220,12-Jun-15,Florida,Allapattah,24th Avenue and 36th Street,0,4,4
355883,11-Jun-15,Texas,Houston,3400 block of Burkett,1,3,4
355644,10-Jun-15,California,Los Angeles,South Vermont Avenue and West 88th Street,1,3,4
355267,9-Jun-15,Missouri,Saint Louis,North Market Street and North Spring Avenue,1,3,4
352779,5-Jun-15,Louisiana,New Orleans,2100 block of Governor Nicholls Street,1,3,4
351936,3-Jun-15,New York,Wyandanch,Davidson Street,3,1,4
350163,31-May-15,Ohio,Cleveland,16209 block of Laverne Avenue,3,1,4
350021,31-May-15,Maryland,Springdale,9222 Ardwick Ardmore Road,1,3,4
349289,30-May-15,California,San Diego,4200 block of Market Street,0,4,4
348606,28-May-15,Nebraska,Omaha,84th and Q,0,4,4
348673,28-May-15,Pennsylvania,Chester,2700 block of West 3rd Street,1,3,4
346725,26-May-15,Louisiana,New Orleans,6700 block of Tara Lane,2,2,4
346320,24-May-15,Alabama,Montgomery,Smiley Court,1,3,4
346179,24-May-15,Missouri,Saint Louis,2700 block of Dayton,0,4,4
346202,23-May-15,California,Fresno,2400 block of South 9th Street,2,2,4
344302,20-May-15,Maryland,Baltimore,800 block of Linwood Avenue,1,3,4
343106,18-May-15,Missouri,Kinloch,8000 block of School Way,0,4,4
341162,16-May-15,New York,Rochester,188 Lewis Street,0,4,4
338034,10-May-15,New Jersey,Jersey City,Bostwick Avenue,0,4,4
337767,10-May-15,New Jersey,Newark,19th Avenue and South 16th Street,1,3,4
335903,7-May-15,Ohio,Cincinnati,2300 block of Baltimore Avenue,0,4,4
336622,7-May-15,Michigan,Detroit,16000 block of Cathedral Street,0,4,4
334681,4-May-15,New York,Buffalo,100 block of Roosevelt Avenue,1,3,4
334033,3-May-15,Indiana,South Bend,1600 block of South William Street,0,4,4
334047,3-May-15,New York,Bronx,University Avenue,0,4,4
330750,27-Apr-15,Arizona,Gila Bend,State Route 85,2,2,4
329463,25-Apr-15,New Jersey,Trenton,Wood Street,0,4,4
325862,19-Apr-15,Virginia,Richmond,200 block of West Hill Street,0,4,4
325166,18-Apr-15,North Carolina,Lumberton,Martin Luther King Drive,1,3,4
325207,18-Apr-15,North Carolina,Charlotte,Bost Street,0,4,4
325618,18-Apr-15,New Jersey,Paterson,Rosa Parks Blvd and Godwin Ave,1,3,4
319808,7-Apr-15,Georgia,Rome,20 Copeland Street,1,3,4
318125,5-Apr-15,Pennsylvania,Pittsburgh,Dinwiddie Street,1,3,4
318531,5-Apr-15,Michigan,Benton Harbor,1000 block of Blossom Lane,0,4,4
317165,3-Apr-15,Florida,Daytona Beach,300 block of Henry Butts Drive,0,4,4
313304,26-Mar-15,Texas,Amarillo,3100 block of Redwood,0,4,4
312119,24-Mar-15,Indiana,Indianapolis,3100 block of North Harding Street,4,0,4
310573,21-Mar-15,Florida,Tampa,1802 Seventh Ave,0,4,4
310356,20-Mar-15,Oklahoma,Oklahoma City,1300 block of N Stiles Ave,0,4,4
308839,18-Mar-15,New Jersey,Newark,200 block of Clinton Place,1,3,4
307512,15-Mar-15,California,Compton,2700 block of West Alondra Boulevard,0,4,4
308201,14-Mar-15,California,Coachella,84000 block of Bagdad Avenue,0,4,4
303659,9-Mar-15,Illinois,Chicago,200 block of West 105th,1,3,4
302786,8-Mar-15,South Carolina,Seneca,Wells Highway,1,3,4
491864,7-Mar-15,Missouri,Saint Louis,3140 Olive St,0,4,4
300660,1-Mar-15,Florida,Orlando,4900 block of Steyr St,0,4,4
299190,28-Feb-15,Maryland,Baltimore,4300 block of Welbourne Road,1,3,4
297681,25-Feb-15,Texas,Houston,5022 Mallow St,3,1,4
588835,23-Feb-15,Florida,Daytona Beach,Sheridan Road,0,4,4
296327,22-Feb-15,South Carolina,Charleston,4224 Dorchester Road,0,4,4
295871,20-Feb-15,California,Sacramento,1417 R Street,0,4,4
295502,17-Feb-15,Arkansas,Little Rock,7900 Scott Hamilton,1,3,4
290626,9-Feb-15,Florida,New Port Richey,9552 Adler Street,3,1,4
286810,31-Jan-15,Georgia,Lagrange,113 Woodstream Trl,4,0,4
285549,28-Jan-15,Georgia,Ellenwood,1600 block of Panola Rd,1,3,4
285123,26-Jan-15,California,Stockton,1500 block of E. 9th Street,1,3,4
281663,20-Jan-15,Tennessee,Clarksville,321 Lansinger Lane,1,3,4
278927,13-Jan-15,Illinois,Rockford,700 block of Oakley Avenue,2,2,4
277480,11-Jan-15,Florida,Lakeland,7665 Chase Road,1,3,4
276536,10-Jan-15,Kansas,Wichita,4859 E Harry Street,2,2,4
276459,9-Jan-15,California,San Francisco,Laguna St and Page St,4,0,4
275986,8-Jan-15,Massachusetts,Boston,104 Harrishof Street,1,3,4
275064,7-Jan-15,Tennessee,Chattanooga,773 West Main Street,1,3,4
274867,6-Jan-15,Florida,Miami,1300 block of NW 62nd Street,1,3,4
273397,4-Jan-15,Texas,Dallas,2000 block of Ben Hur St.,3,1,4
271363,29-Dec-14,Louisiana,New Orleans,Poydras and Bolivar,0,4,4
269679,27-Dec-14,California,Los Angeles,8800 block of South Figueroa Street,1,3,4
270036,27-Dec-14,California,Sacramento,4000 block of May Street,0,4,4
269167,26-Dec-14,Illinois,East St. Louis,2500 block of Summit Avenue,1,3,4
268598,24-Dec-14,Missouri,Saint Louis,18th and Pine,1,3,4
267792,23-Dec-14,Kentucky,Winchester,260 Oxford Drive,1,3,4
268282,22-Dec-14,Michigan,Detroit,Charlevoix and Philip,1,3,4
266570,21-Dec-14,Florida,Sarasota,4034 N Washington Blvd,2,2,4
266407,20-Dec-14,Illinois,Rockford,3200 block of Montrose Avenue,4,0,4
264901,16-Dec-14,New Jersey,Elizabeth,Anna Street,0,4,4
262202,12-Dec-14,Oregon,Portland,717 North Killingsworth Court,0,4,4
259935,7-Dec-14,Indiana,South Bend,16000 block of Roosevelt Road,0,4,4
226388,30-Nov-14,New York,Brooklyn,375 Remsen Avenue,0,4,4
226150,29-Nov-14,New Jersey,Newark,348 S Orange Ave,1,3,4
225830,28-Nov-14,Tennessee,Memphis,1849 East Brooks Road ,0,4,4
224362,23-Nov-14,Virginia,Parksley,Parksley Road,0,4,4
223729,22-Nov-14,Ohio,Springfield,Clifton Avenue and Rice Street,1,3,4
222792,19-Nov-14,Illinois,Chicago,700 block of North St. Louis Avenue,1,3,4
222393,18-Nov-14,Nevada,North Las Vegas,Englestad Street,0,4,4
221347,15-Nov-14,Missouri,Springfield,2555 N. Glenstone,4,0,4
221577,15-Nov-14,Florida,Miami,NW 55th and 12th,1,3,4
218054,7-Nov-14,California,Los Angeles,East 126th Street and North Compton Avenue,0,4,4
217401,7-Nov-14,California,Compton,136th Street ,0,4,4
216533,5-Nov-14,California,San Francisco,1100 block of Alabama Street ,0,4,4
211348,26-Oct-14,Kentucky,Cadiz,1410 Old Dover Road,4,0,4
209134,18-Oct-14,New York,Queens,33-02 Queens Blvd,0,4,4
207687,18-Oct-14,New York,Brooklyn,Lenox Road,0,4,4
207145,18-Oct-14,South Carolina,Graniteville,192 Breezy Hill Road,1,3,4
206303,16-Oct-14,Michigan,Detroit,Mogul Street,1,3,4
205298,13-Oct-14,Georgia,Atlanta,85 Mount Zion Road,0,4,4
204310,12-Oct-14,California,Stockton,1100 block of East March Lane,3,1,4
204477,12-Oct-14,Georgia,Atlanta,Arthur Langford Jr Place,1,3,4
204254,8-Oct-14,New York,Guilderland,1846 Western Ave,4,0,4
202981,8-Oct-14,Georgia,Atlanta,Auburn Avenue and Edgewood Avenue,0,4,4
201630,5-Oct-14,Florida,Jacksonville,7300 block of Linda Drive,3,1,4
201648,4-Oct-14,Tennessee,Memphis,1400 block of Gherald Street,2,2,4
201502,4-Oct-14,California,Pomona,1925 West Holt Avenue ,0,4,4
198527,29-Sep-14,California,Fresno,2300 block of West Fountain Way ,0,4,4
197416,28-Sep-14,Pennsylvania,Philadelphia,2800 block of Hope Street,0,4,4
194945,21-Sep-14,Ohio,East Liverpool,440 First St,0,4,4
193960,20-Sep-14,Mississippi,Batesville,8297 Curtis Rd,2,2,4
193570,19-Sep-14,New York,Queens,32-14 106th St,0,4,4
190874,14-Sep-14,Texas,Flour Bluff,229 Naval Air Station Drive,3,1,4
2172621,14-Sep-14,Texas,Corpus Christi,229 NAS Dr,3,1,4
188332,6-Sep-14,Florida,Orlando,2015 Orange Blossom Trail,0,4,4
182974,29-Aug-14,Florida,Brooksville,820 Peach St,3,1,4
181947,27-Aug-14,Michigan,Detroit,16600 block of Edmore,1,3,4
180018,24-Aug-14,Illinois,Chicago,8300 block of South Halsted Street,1,3,4
180580,24-Aug-14,Georgia,Augusta,1013 Carrie Street,1,3,4
178006,18-Aug-14,Louisiana,Saint Martinville,Main and Hyacinth streets,0,4,4
175839,17-Aug-14,Nevada,Las Vegas,Owens Avenue and H Street,0,4,4
175911,17-Aug-14,New York,Queens,153-38 118th Ave,0,4,4
175943,17-Aug-14,Massachusetts,Boston,Edinboro Street,0,4,4
177770,17-Aug-14,California,East Palo Alto,Purdue Street and Georgetown Avenue,1,3,4
175779,16-Aug-14,New Jersey,Plainfield,West 3rd Street and Monroe Avenue,1,3,4
174560,14-Aug-14,Tennessee,Memphis,797 Pope Street,1,3,4
174544,13-Aug-14,Tennessee,Clarksville,Treeland Drive,0,4,4
175767,13-Aug-14,Louisiana,New Orleans,New Orleans and North Rocheblave streets,0,4,4
173369,12-Aug-14,New York,Buffalo,Oakmont Ave,1,3,4
173786,8-Aug-14,District of Columbia,Washington,2nd St NE and Todd Pl NE,0,4,4
171823,8-Aug-14,New Mexico,Albuquerque,3426 Vassar NE,1,3,4
171778,8-Aug-14,Wisconsin,Milwaukee,3000 block of N. 28th Street ,0,4,4
170704,6-Aug-14,California,Bakersfield,1700 block of Quincy Street ,3,1,4
167872,2-Aug-14,Texas,Dallas,5125 Wynell Street,3,1,4
167649,1-Aug-14,Pennsylvania,Philadelphia,1500 block of South Etting Street,1,3,4
166970,26-Jul-14,Arkansas,Pine Bluff,Third Ave and Redbud St,1,3,4
162687,23-Jul-14,Pennsylvania,Braddock,700 block of Hickory St,0,4,4
162008,21-Jul-14,Tennessee,Memphis,300 block of Foote Park Lane,0,4,4
161063,20-Jul-14,Nevada,Las Vegas,3400 block of N Rancho Dr,1,3,4
160998,20-Jul-14,Illinois,East Saint Louis,5103 block of Bunkum Rd,1,3,4
160488,19-Jul-14,Illinois,Chicago,1300 North Mason Avenue,0,4,4
159291,13-Jul-14,District of Columbia,Washington,1700 block of Lincoln Rd NE,0,4,4
157580,11-Jul-14,Illinois,Chicago,5200 West Quincy Street,1,3,4
162305,7-Jul-14,Kentucky,Stopover,KY 194E,0,4,4
156125,6-Jul-14,Florida,Miami,NW 20th Ave and NW 62nd St,2,2,4
155412,6-Jul-14,Missouri,Saint Louis,4600 block of Natural Bridge Avenue,0,4,4
155755,6-Jul-14,New York,Buffalo,100 block of Erb Street,0,4,4
153275,30-Jun-14,Kentucky,Lexington,Scottsdale Circle,1,3,4
153648,29-Jun-14,Missouri,Saint Louis,2800 block of Dayton,0,4,4
153578,28-Jun-14,New York,Manhattan,Fifth Avenue and West 139th Street,0,4,4
152722,27-Jun-14,California,San Diego,1600 block of Cathy Street,1,3,4
157018,26-Jun-14,Michigan,Detroit,Grand St,2,2,4
154136,22-Jun-14,California,Windsor,Windsor Avenue,1,3,4
149954,21-Jun-14,District of Columbia,Washington,Florida Ave NW and U St NW,0,4,4
157013,20-Jun-14,Maryland,Seat Pleasant,6600 block of Greig Street,0,4,4
146565,15-Jun-14,Indiana,Kokomo,5100 Clinton Drive,0,4,4
146586,15-Jun-14,Illinois,Park Forest,200 Berry Street,0,4,4
149706,13-Jun-14,California,Los Angeles,8600 block of South Figueroa Street,3,1,4
143979,7-Jun-14,Michigan,Oak Park,10811 W. Ten Mile Rd.,1,3,4
142822,4-Jun-14,Illinois,Chicago,4900 West West End Avenue,1,3,4
141792,1-Jun-14,California,Sacramento,6500 46th Street,0,4,4
153532,31-May-14,California,San Bernardino,800 block of West Victoria St,1,3,4
139281,25-May-14,Ohio,Toledo,2100 block of Joffre Avenue,1,3,4
138567,24-May-14,Michigan,Detroit,Strathmoor St,0,4,4
138645,24-May-14,South Carolina,Myrtle Beach,104 N Ocean Blvd,3,1,4
138370,23-May-14,California,Bellflower,9541 Flower Street,2,2,4
142123,21-May-14,Texas,Dallas,4500 block of Village Fair Drive,1,3,4
136567,17-May-14,California,Coachella,84000 block of Pedro Drive,1,3,4
134591,12-May-14,Illinois,Chicago,3400 West 24th Street,0,4,4
134044,10-May-14,Georgia,Stone Mountain,1100 To Lani Farm Road,1,3,4
131697,4-May-14,Illinois,Chicago,500 West Erie Street,1,3,4
132897,4-May-14,Colorado,Wheat Ridge,12100 W 44th,0,4,4
130933,30-Apr-14,Illinois,Chicago,7200 South Phillips Avenue,0,4,4
173109,22-Apr-14,California,Los Angeles,6419 Brynhurst Avenue,1,3,4
127381,20-Apr-14,Florida,Tampa,2902 N. 32nd St.,2,2,4
156828,14-Apr-14,District of Columbia,Washington,1909 19th St SE,0,4,4
125028,12-Apr-14,Louisiana,New Orleans,2100 block of Pauger Street,1,3,4
124146,11-Apr-14,Indiana,Richmond,North 15th and H Streets,0,4,4
123891,9-Apr-14,Tennessee,Lookout Valley,Kellys Ferry Road and Kellys Ferry Place,3,1,4
123008,7-Apr-14,Louisiana,New Orleans,500 block of South Alexander Street,0,4,4
123666,6-Apr-14,Massachusetts,Springfield,90 Worthington St.,0,4,4
125863,6-Apr-14,Oklahoma,Oklahoma City,Northwest 29th Street and Portland Avenue,0,4,4
122612,5-Apr-14,Arizona,Phoenix,5400 block of W Palm Ln,1,3,4
122672,5-Apr-14,California,Fairfield,Orchid Street ,0,4,4
117818,23-Mar-14,Texas,Arlington,2700 Majesty Drive,1,3,4
172722,23-Mar-14,California,Long Beach,601 Long Beach Boulevard,1,3,4
117642,21-Mar-14,South Carolina,North Charleston,7550 Dorchester Road,0,4,4
117591,16-Mar-14,Texas,Beaumont,S 4th St,3,1,4
125855,16-Mar-14,Georgia,Waynesboro,4960 Highway 80 West ,0,4,4
115012,14-Mar-14,New York,Brooklyn,S. Second and Roebling Sts,0,4,4
113156,9-Mar-14,Ohio,Fremont,531 W State St,3,1,4
113255,8-Mar-14,California,Richmond,1600 block of First Street,1,3,4
112415,5-Mar-14,South Carolina,Pelzer,Law St,3,1,4
111109,1-Mar-14,Michigan,Detroit,7800 Gratiot Av.,0,4,4
109142,22-Feb-14,California,Wilmington,1200 block of W Papeete St,0,4,4
108691,20-Feb-14,Indiana,Indianapolis,3400 block of South Parker,4,0,4
106243,12-Feb-14,California,Stockton,1101 E Lindsay St,1,3,4
106481,12-Feb-14,California,Oakland,37th and International ,1,3,4
105010,6-Feb-14,Louisiana,New Orleans,4600 block of Downman Road,0,4,4
104218,5-Feb-14,Illinois,Chicago,6740 N Clark St,1,3,4
101301,27-Jan-14,North Carolina,Rocky Mount,821 Word Plaza,0,4,4
100568,25-Jan-14,Florida,Belle Glade,600 block of Covenant Drive,0,4,4
104902,20-Jan-14,Virginia,Manassas,8509 Rixlew Ln,0,4,4
96792,14-Jan-14,California,Los Angeles,West 86th Street,0,4,4
96185,13-Jan-14,Michigan,Detroit,800 block of Calvert St,0,4,4
95146,11-Jan-14,Mississippi,Jackson,3430 W. Capitol Street,0,4,4
94514,5-Jan-14,Pennsylvania,Erie,829 Parade St,1,3,4
92704,3-Jan-14,New York,Queens,Farmers Boulevard and 133rd Avenue,1,3,4
92194,1-Jan-14,Virginia,Norfolk,Rockingham Street and Berkley Avenue Extended,2,2,4
495577,25-Dec-13,New York,Medford,33A Cedarhurst Ave,1,3,4
495566,22-Dec-13,Michigan,Muskegon,2300 block of W McMillan Rd,1,3,4
495557,21-Dec-13,North Carolina,Shelby,Jose Street,0,4,4
495543,15-Dec-13,Florida,Homestead (Florida City),7th Avenue and 13th Terrace,1,3,4
495506,14-Dec-13,North Carolina,Statesville,167 Wallace Springs,0,4,4
495374,7-Dec-13,Delaware,Wilmington,3421 Kirkwood Hwy,0,4,4
495332,1-Dec-13,Kansas,Topeka,1629 SW Central Park,4,0,4
495347,1-Dec-13,Florida,Miami,NW 64th Street and 12th Avenue,2,2,4
495268,30-Nov-13,Georgia,Valdosta,Gordon Street and North Ashley Street,0,4,4
495195,29-Nov-13,California,Fresno,Oleander and Modoc,0,4,4
495178,29-Nov-13,Indiana,Indianapolis,3400 block of East 34th Street,0,4,4
495171,28-Nov-13,New York,Rochester,St. Paul Boulevard and Andrews Street,0,4,4
494215,25-Nov-13,Minnesota,Minneapolis,1611 E Lake St,1,3,4
494116,21-Nov-13,Pennsylvania,Philadelphia,1400 block of N. 60th Street,0,4,4
494033,15-Nov-13,Texas,Houston,4400 block of Tiffany,1,3,4
493893,10-Nov-13,Ohio,Canton,1215 Tuscarawas St W,1,3,4
493863,10-Nov-13,Arizona,Phoenix,5800 South 53rd Glen,1,3,4
492999,6-Nov-13,District of Columbia,Washington,3900 block of Minnesota Ave,1,3,4
493109,5-Nov-13,Florida,Jacksonville,1100 block of Randolph,4,0,4
492950,3-Nov-13,California,Los Angeles,1 World Way,1,3,4
492933,2-Nov-13,Kentucky,Radcliff,355 Shelby Avenue,1,3,4
492699,27-Oct-13,California,Roseville,6th Street and Hampton,0,4,4
492427,27-Oct-13,Texas,Beaumont,500 block of Edgemore Drive,0,4,4
481419,26-Oct-13,Florida,Miami Gardens,NW 187 Street and 30 Avenue,0,4,4
481263,20-Oct-13,Florida,Miami,19600 block of Southwest 168th Street,2,2,4
481254,20-Oct-13,Florida,Margate,7400 block of Santa Monica Drive,0,4,4
480981,9-Oct-13,Texas,Paris,400 block of NE 6th Street,4,0,4
480897,6-Oct-13,Arizona,Avondale,11120 W Van Buren St,0,4,4
480882,5-Oct-13,New York,Buffalo,102  Zelmer Street,0,4,4
480747,2-Oct-13,Nebraska,Omaha,North 42nd and Browne streets,0,4,4
480730,29-Sep-13,Illinois,Chicago,6000 block of South Indiana Avenue,0,4,4
480720,27-Sep-13,Ohio,Zanesville,753 Putnam Ave,0,4,4
480700,25-Sep-13,North Carolina,Haw River,1003 W. Main St,0,4,4
480661,22-Sep-13,Missouri,Saint Louis,3916 North Florissant Road,1,3,4
480632,21-Sep-13,Florida,Palm Beach,2600 block of Forest Hill Boulevard,0,4,4
480582,20-Sep-13,California,Long Beach,6500 block of Rose Avenue,2,2,4
480453,17-Sep-13,Nevada,Las Vegas,1300 block of Bartlett Avenue,0,4,4
480415,17-Sep-13,Michigan,Lansing,1500 block of Ottawa Street,0,4,4
480058,15-Sep-13,Georgia,Snellville,4630 Anderson Livsey Lane,3,1,4
479821,14-Sep-13,North Carolina,Marion,80 Finley Road,0,4,4
479747,12-Sep-13,Tennessee,Crab Orchard,N/A,4,0,4
479757,12-Sep-13,District of Columbia,Washington,First Street and Pierce Street NW,1,3,4
479774,11-Sep-13,New York,New York,204 Varick St,0,4,4
479727,7-Sep-13,Missouri,Saint Louis,5000 block of Durant Ave,1,3,4
479682,5-Sep-13,North Carolina,Charlotte,2500 block of Pinckney Avenue,0,4,4
479646,25-Aug-13,California,Oakland,1300 block of 104th Avenue,0,4,4
492270,25-Aug-13,Minnesota,Minneapolis,2600 block of Cedar and 2600 block of 18th Avenue South,2,2,4
492260,25-Aug-13,South Carolina,Latta,214 Willis St,1,3,4
491992,20-Aug-13,Maryland,Baltimore,1200 block of S. Carey St,2,2,4
491948,18-Aug-13,New Jersey,Port Norris,1600 block of North Avenue,0,4,4
491937,18-Aug-13,Ohio,Toledo,2272 Scottwood Ave,0,4,4
491840,18-Aug-13,Illinois,Chicago,100 block of South Springfield,1,3,4
491819,17-Aug-13,California,San Francisco,1738 Telegraph Avenue,0,4,4
492001,14-Aug-13,Oklahoma,Oklahoma City,4601 SE 79,4,0,4
491770,13-Aug-13,Pennsylvania,Philadelphia,1100 block of Divinity Street,0,4,4
491710,11-Aug-13,New York,Brooklyn,395 East 48th Street,0,4,4
491729,10-Aug-13,Delaware,Wilmington,1200 block of Second Street,0,4,4
491734,9-Aug-13,Missouri,Saint Louis,4200 block of Kossuth Ave,2,2,4
491630,6-Aug-13,New Jersey,Montclair,Mission Street,0,4,4
491546,4-Aug-13,Missouri,Kansas City,2400 block of  Park Avenue,1,3,4
491438,2-Aug-13,Indiana,Indianapolis,62nd and College Ave,0,4,4
491292,30-Jul-13,New Mexico,Hobbs,2000 block of North Bensing Rd,0,4,4
491281,29-Jul-13,Washington,Granger,300 block of S. Outlook Rd.,0,4,4
491287,28-Jul-13,Texas,Dallas,2400 block of Royal Lane,0,4,4
491253,26-Jul-13,West Virginia,Clarksburg,743 Locust Avenue,4,0,4
491243,25-Jul-13,Michigan,Inkster,Oakwood Street,0,4,4
491226,24-Jul-13,Kansas,Topeka,221 SE Lawrence St,0,4,4
491214,21-Jul-13,New York,Brooklyn,1445 Lincoln Place,0,4,4
491082,19-Jul-13,Connecticut,Hartford,3155 Main St,0,4,4
491073,19-Jul-13,California,Madera,Yosemite Avenue and Cleveland,0,4,4
491046,17-Jul-13,California,Oakland,3400 block of Wilson Avenue,1,3,4
491162,13-Jul-13,Ohio,Campbell,Seventh Street,0,4,4
490979,13-Jul-13,District of Columbia,Washington,2700 block of Stanton Road,0,4,4
490963,13-Jul-13,Oklahoma,Oklahoma City,5405 N. Lincoln Blvd,1,3,4
490943,12-Jul-13,California,San Francisco,3192 16th St,1,3,4
490954,12-Jul-13,Kentucky,Greensburg,194 C Mays Rd,2,2,4
490922,11-Jul-13,North Carolina,Charlotte,6300 block of Reagan Drive,2,2,4
490917,9-Jul-13,Illinois,Rockford,600 block of Woodlawn Avenue,2,2,4
490909,9-Jul-13,Maryland,Baltimore,600 block of N. Carrollton Ave,0,4,4
490793,7-Jul-13,Florida,Pompano Beach,1600 block of Northwest 7th Lane,1,3,4
490767,7-Jul-13,Mississippi,Meridian,2500 block of 5th Street,0,4,4
490395,6-Jul-13,Alabama,Florence,West Mobile Street,0,4,4
490750,6-Jul-13,New York,Brooklyn,472 Marcy Avenue,1,3,4
490335,4-Jul-13,Illinois,Chicago,6000 block of South Cottage Grove Avenue,0,4,4
490245,1-Jul-13,Texas,Fort Worth,2900 block of Pate Drive,4,0,4
490166,30-Jun-13,Colorado,Aurora,2300 block of Paris St,0,4,4
490150,29-Jun-13,South Carolina,North Charleston,4400 Dorchester Road; Suite 115,3,1,4
490048,27-Jun-13,California,Three Rivers,39553-39833 Sierra Dr,2,2,4
489987,25-Jun-13,Illinois,Chicago,S King Dr and E 73rd St,1,3,4
489934,24-Jun-13,Missouri,Kansas City,1711 Kansas Avenue,1,3,4
489121,23-Jun-13,Louisiana,New Orleans,5700 block of Wickfield Drive,0,4,4
489096,23-Jun-13,California,Sacramento,Sea Drift Way,1,3,4
489061,23-Jun-13,Tennessee,Chattanooga,1501 Dodds Ave,1,3,4
488970,22-Jun-13,Rhode Island,Providence,55 Curtis,0,4,4
488426,21-Jun-13,Illinois,Chicago,2900 block of North Kilpatrick Avenue,1,3,4
488134,16-Jun-13,Illinois,Chicago,900block of East 79th Street,1,3,4
487891,15-Jun-13,Texas,Houston,9780 Bissonnet,1,3,4
487833,15-Jun-13,Tennessee,Nashville,135 Brinkhaven Ave,0,4,4
488992,15-Jun-13,Rhode Island,Providence,256 Hartford Ave,1,3,4
487645,9-Jun-13,Pennsylvania,York,600 block of West Princess Street,0,4,4
487266,2-Jun-13,Indiana,Indianapolis,1913 East 46th Street,0,4,4
489314,1-Jun-13,California,Vallejo,1st block of Linfield Drive,2,2,4
487261,1-Jun-13,Wisconsin,Milwaukee,4126 N Teutonia Ave,0,4,4
487088,31-May-13,Georgia,Atlanta,1000 block of Fair Street,0,4,4
487082,29-May-13,Illinois,Chicago,N/A,0,4,4
487052,28-May-13,Tennessee,Memphis,2850 Brewer Avenue,1,3,4
486977,25-May-13,Michigan,Flint,1100 block of Paterson,1,3,4
486971,24-May-13,California,Bakersfield,3700 block of Columbus Street,2,2,4
486623,23-May-13,Tennessee,Bean Station,1034 Main Street,2,2,4
486617,20-May-13,Illinois,Chicago,5200 block of West Iowa Street,0,4,4
486605,19-May-13,Michigan,Detroit,N/A,0,4,4
486586,19-May-13,Tennessee,Memphis,2281 Ketchum Rd,2,2,4
486611,18-May-13,Virginia,Victoria,2073 Pleasant Oak Rd,0,4,4
486334,16-May-13,Pennsylvania,Philadelphia,2600 block of Daggett Street,0,4,4
486316,13-May-13,Ohio,Cincinnati,Kings Run Road,0,4,4
486244,11-May-13,New Jersey,Jersey City,Fremont Street,0,4,4
486121,11-May-13,Pennsylvania,Philadelphia,21st Street and Medary Avenue,0,4,4
486109,10-May-13,California,Los Angeles,1600 block of West 205th Street,3,1,4
486068,6-May-13,Pennsylvania,Johnstown,Horner and Messenger streets,0,4,4
486027,4-May-13,North Carolina,Smithfield,150 South Equity Drive,0,4,4
485979,28-Apr-13,Tennessee,Jackson,438 East Main Street,2,2,4
485885,28-Apr-13,Pennsylvania,Chester,Rose and Upland Street,1,3,4
485821,27-Apr-13,Florida,Williston,County Road 318,1,3,4
489185,25-Apr-13,Ohio,Oberlin,500 block of West College Street,0,4,4
484351,22-Apr-13,Illinois,Chicago (Englewood),5700 block of South Lowe Avenue,0,4,4
484317,18-Apr-13,Ohio,Akron,Kimlyn Circle,4,0,4
484279,10-Apr-13,California,Vallejo,1800 block of Mini Drive,0,4,4
484268,9-Apr-13,Pennsylvania,Philadelphia,Somerset Street and Lee Street,1,3,4
483878,7-Apr-13,California,Long Beach,300 block of East Home Street,1,3,4
483872,7-Apr-13,New York,New York (Manhattan),900 Garden Way,1,3,4
483788,22-Mar-13,New York,Brooklyn,2703 W. 33rd Street,1,3,4
483765,21-Mar-13,Missouri,Kansas City,4900 block of Brookside Blvd,1,3,4
482838,14-Mar-13,California,Modesto,1400 block of Western Way,0,4,4
482801,13-Mar-13,California,Oceanside,504 Calle Montecito,2,2,4
481229,7-Mar-13,Mississippi,Jackson,2900 block of Greenwood Avenue,2,2,4
481220,5-Mar-13,Indiana,Indianapolis,1800 block of Edinburge Square,1,3,4
481213,4-Mar-13,California,Los Banos,800 block of La Mesa Lane,1,3,4
481208,3-Mar-13,Michigan,Saginaw,4030 Dixie Hwy,0,4,4
481198,3-Mar-13,Georgia,Moultrie,224 Second Street Northwest,2,2,4
481186,2-Mar-13,Louisiana,Shreveport,7000 block of Burlingame Boulevard,1,3,4
480407,23-Feb-13,California,Lancaster,43145 Business Center Parkway,0,4,4
480401,22-Feb-13,Michigan,Grand Rapids,1447 Grandville Ave. SW,0,4,4
480383,21-Feb-13,Oklahoma,Tulsa,1200 block of North 89th East Avenue,1,3,4
479603,9-Feb-13,Louisiana,New Orleans,400 block of Bourbon Street,0,4,4
479592,7-Feb-13,Illinois,Chicago,2500 block of East 75th Street,0,4,4
479580,3-Feb-13,California,Marysville (Linda),5800 block of Poplar Avenue,1,3,4
479460,26-Jan-13,Ohio,Springfield,601 West Main Street,1,3,4
479413,25-Jan-13,Missouri,Saint Louis,W Florissant Ave and Riverview Blvd,1,3,4
491674,23-Jan-13,Tennessee,Chattanooga,1501 Dodds Ave,1,3,4
479389,21-Jan-13,California,Brentwood,1100 block of Breton Drive,0,4,4
478948,7-Jan-13,Oklahoma,Tulsa,6000 block of South Owasso,4,0,4
460726,1-Jan-13,California,Hawthorne,13500 block of Cerise Avenue,1,3,4
461105,1-Jan-13,Pennsylvania,Mckeesport,1506 Versailles Avenue and Coursin Street,0,4,4