datetime,date,time,result,balance,fee,hash,ver,vin_sz,vout_sz,size,weight,tx_index,block_index,block_height
2021-12-07 21:21:37,2021-12-07,21:21:37,1055733,20209519,541,fb4f06c6e58af5cc365a0109480e501eec172958828709e78861f3a8c013fd2d,2,2,1,344,722,1618079403810412,713104,713104
2021-12-07 16:30:10,2021-12-07,16:30:10,1666388,19153786,11245,46bedd9794ccf60a7cfed37e7f7d6d13ed3d508449c2159283a8c9d2278e61b1,1,1,79,2743,10645,6241041757395253,713064,713064
2021-12-07 09:31:01,2021-12-07,09:31:01,1921254,17487398,745,6c742784cfae27b6cd56c30fe0237302d1365d0dfe491a1675a3285dd2a19d13,1,3,1,491,992,690167862764820,713015,713015
2021-12-07 09:05:23,2021-12-07,09:05:23,2035140,15566144,338,63c485763d5de79bd4c32354527de408cc3d2fa86502da1e8c8b68922d5d2715,2,1,1,194,449,744281957616913,713013,713013
2021-12-07 07:17:22,2021-12-07,07:17:22,97814,13531004,540,53cec7da7caa99d8ec4abf1bee3411fbfb18fff27b95fa8c85836e7bdaa25297,2,2,2,374,845,5324197610876368,713003,713003
2021-12-07 06:56:44,2021-12-07,06:56:44,1516320,13433190,338,bdaefd337abb6f2a9e6f119e1767053dce04b2fc24c39252b95a3576356fe071,2,1,1,195,450,4006680076404395,713000,713000
2021-12-06 00:15:46,2021-12-06,00:15:46,307609,11916870,338,cc3d48c8007c85b5dbe3b2411fd724a9e9c86af4e54f3c70c366179c12f3d382,2,1,1,194,449,4603098489389804,712794,712794
2021-12-05 21:17:10,2021-12-05,21:17:10,493321,11609261,338,17e7c5502d6dc219077a9c3b1eea436f00df8d48f278024c40ffe12513b1cd49,2,1,1,195,450,2596729214254143,712776,712776
2021-12-05 16:08:07,2021-12-05,16:08:07,124833,11115940,53010,408ef61dfc2435aa07debd7a587478f9c2618a02915aa470e3036309241bff1b,1,1,78,2709,10509,985039550622816,712740,712740
2021-12-05 13:59:54,2021-12-05,13:59:54,235952,10991107,338,b90c0950f771bfcd70d0ba959e2b3072ae382d52a774f74c3215271cd09db9b6,2,1,1,194,449,6429066651731170,712725,712725
2021-12-05 07:36:24,2021-12-05,07:36:24,973941,10755155,3646,c873388b55a400284c1eb86af9f6924ca73fb00d7b930759fe476c255adc2171,2,1,1,194,449,3980487832153480,712676,712676
2021-12-05 00:32:05,2021-12-05,00:32:05,307576,9781214,2363,54c0cf315a8894ed3b1069babc14a20faae842ce3dec4c04f417d55e701c59ee,2,1,1,195,450,8386127892044450,712628,712628
2021-12-04 17:21:33,2021-12-04,17:21:33,1058603,9473638,338,33ba4a7f0273fda15d38c1025313a41fc78bb95a9beb3f81ec3c61e560810e7b,2,1,1,194,449,4329671371828263,712593,712593
2021-12-04 11:46:08,2021-12-04,11:46:08,172969,8415035,18039,bdddf074457b402bc066e76729ed44020ab464148c83e533524f6d75abc2134f,1,1,58,2046,7857,2782281247665577,712558,712558
2021-12-04 08:37:07,2021-12-04,08:37:07,280359,8242066,541,91e5f3a8a02a3fb6c15e851b3175fa3ba6dd66afea9d2f90f858b4ee51d4c903,2,2,1,343,721,133292334372491,712529,712529
2021-12-04 08:28:13,2021-12-04,08:28:13,608022,7961707,1220,c0ffc5ec37362b446c765dad81e015626053f406b3bc1f6869904d19a3d1958f,2,1,1,194,449,5051956160833970,712527,712527
2021-12-03 17:02:13,2021-12-03,17:02:13,169312,7353685,8136,e72aa74e991dcf85743be36fde2609b152ca08a9baba8033fe8b983dbd39002c,1,1,2,225,900,1548143370416913,712424,712424
2021-12-03 15:36:12,2021-12-03,15:36:12,235969,7184373,1463,2dccf8f77dd3c777e63451acebcb7c6a551ee2a483dec0c1ddd6d02cf220c59b,2,1,1,195,450,5480670835350042,712411,712411
2021-12-02 19:47:17,2021-12-02,19:47:17,269564,6948404,338,530f30d099f5320249f3d1f10f3f351527de8b57b89fd62651c11d26e81d3420,2,1,1,195,450,1133062788531128,712284,712284
2021-12-02 06:41:48,2021-12-02,06:41:48,639301,6678840,541,4a30df1a1c12a1fb06853a80ed69a0f864f04283844a04f4d9a4cd86e4d76415,2,2,1,344,722,752731615713716,712201,712201
2021-12-01 07:30:57,2021-12-01,07:30:57,-4707606,6039539,791887,806cbe04e93011b7e1b8cf8158a29c6e544f324ca5bafedce7ccda60491567a1,2,670,2,98906,395624,5678851546684249,712177,712177
2021-12-01 07:24:28,2021-12-01,07:24:28,-2237705,10747145,294653,defe12a562867911411e9abdcb947b22ffc6790b589304ec6eee37b814c6dd60,2,249,2,36797,147188,3408180073137917,712169,712169
2021-12-01 07:31:00,2021-12-01,07:31:00,-2755655,12984850,458834,e030ebe2f55da9aaa40562c90abb8f948b84f6c84704bdc6fd8102628c52a24d,2,388,2,57310,229240,2731506079121488,712151,712151
2021-12-01 17:25:58,2021-12-01,17:25:58,835798,15740505,1350,389ba5dde69c5b34f403e3ff80b23ec93c5df4316dfe067c709b3a9801c8e77e,2,1,1,194,449,4465086658971475,712115,712115
2021-12-01 16:05:09,2021-12-01,16:05:09,37434,14904707,32239,0d451f293e370cf49c8f14047000b471417a166426341cc49d25bf02e82aa4ae,1,1,87,2977,11578,6144643766966244,712105,712105
2021-12-01 10:01:55,2021-12-01,10:01:55,-751339,14867273,71799,a69885591654ec725f846f3ee9736d9c890d9888fd75b0a39c8e522a415b363f,2,57,2,8478,33912,2224086136998481,712082,712082
2021-12-01 07:31:00,2021-12-01,07:31:00,-855382,15618612,109230,b42d78fe6235db1f1e7e8159b910aa0322e22be2156a87cade7e2ebf0db528e9,2,92,2,13640,54560,8203553457300943,712070,712070
2021-12-01 07:30:55,2021-12-01,07:30:55,-15680862,16473994,501351,786061cc81367f1bf5d9d7f4aa10ef7c2d970a8f5c6ff0cb00b882f25fcbd2bc,2,424,2,62603,250412,6643633318940759,712069,712069
2021-12-01 08:44:33,2021-12-01,08:44:33,1175696,32154856,1350,6d5ea21c56e339f857c111617e83c3ccb7ef1c2c585579daf09c93fbbdbfe34d,2,1,1,195,450,2740498234045043,712056,712056
2021-11-30 19:34:10,2021-11-30,19:34:10,517333,30979160,788,9f6be91bb3997798ff604a22ba2fc67928e59a4085b450f126f7baab79d8f990,2,1,1,195,450,5100888099485534,711992,711992
2021-11-30 14:15:54,2021-11-30,14:15:54,235555,30461827,338,86245f540a0873133c40caa46f5c84fa36c87e99b8bed813e3ad3e6351c41877,2,1,1,195,450,4190344210835413,711971,711971
2021-11-30 12:56:01,2021-11-30,12:56:01,538408,30226272,338,6b4e35c068e882ca7a39d25f28bef4dfb0dedb6871f8b6cb9b73d924fb480cf2,2,1,1,194,449,8516306494331694,711957,711957
2021-11-30 06:44:10,2021-11-30,06:44:10,688244,29687864,7149,82cb2fead9f877ddc38d5724a78c698501cc0b1296713a40b5aa8770eb906ffb,1,1,44,1612,6121,8846610921296117,711922,711922
2021-11-29 19:05:29,2021-11-29,19:05:29,578564,28999620,338,be187e5d60c9ad20bc5870e018fbe29c4ee98ba9cc76d1b09a1fa8764ac7f432,2,1,1,194,449,1792860702561539,711846,711846
2021-11-29 14:53:41,2021-11-29,14:53:41,855382,28421056,338,a5ddd87646fccf8d790944a64e6ca0dd5f985a74682645b42258cab8681b54f3,2,1,1,195,450,8561362004810059,711836,711836
2021-11-28 16:55:54,2021-11-28,16:55:54,234818,27565674,338,f68d497a965026dc723cde81eb7afd9bd7b975c153ff35520e0fefd863a0435f,2,1,1,195,450,3351809867062753,711681,711681
2021-11-28 09:52:54,2021-11-28,09:52:54,347557,27330856,338,ec3e94ee47b6ae1d72c8125f997a6eee206f6b50825ed66293ccfd210f06f83d,2,1,1,194,449,2180334810841017,711643,711643
2021-11-27 19:00:08,2021-11-27,19:00:08,1535204,26983299,1237,4af78c9c66e0d888f28fff92d071de5061330a56e8447852b43e39b7ecc0e1e2,2,3,2,523,1117,7982695432251175,711569,711569
2021-11-27 08:16:45,2021-11-27,08:16:45,271460,25448095,338,b6db4c5335cd9c6c3de2ee5c1afceeb4f6a17bb871183269053948eb7cc6260e,2,1,1,195,450,497910451890439,711500,711500
2021-11-27 06:55:43,2021-11-27,06:55:43,370041,25176635,420,0534762c796a1700953ba783e209363072280d94d75935239f99795dc4ef6a9b,1,1,2,226,574,5468274926792499,711494,711494
2021-11-26 21:27:21,2021-11-26,21:27:21,1828718,24806594,338,ac0a5b9faa47f9c3409fbfa5137caf2f1b13f76240457d6bc21eb3e394fba74f,2,1,1,195,450,2802652767090275,711441,711441
2021-11-26 18:30:09,2021-11-26,18:30:09,388529,22977876,31881,1489011499f3dfa4f030e1db6d69d21a6caeda0cc235b7add8a1a6193b52b120,1,1,89,3069,11946,1150270748964052,711424,711424
2021-11-26 18:14:44,2021-11-26,18:14:44,751339,22589347,541,eee4ff4691e6ca9235d45ae5ab9e9665e285614babd254f675de5c785b55c44f,2,2,1,342,720,2806549255752603,711422,711422
2021-11-25 15:23:56,2021-11-25,15:23:56,2237705,21838008,5462,e02fa6558f1199d4423f120c7ae2d364bcc86c669d9944ecc6fefc560e6eaa4c,2,6,1,937,1807,2697435986714527,711277,711277
2021-11-25 11:21:52,2021-11-25,11:21:52,167184,19600303,3328,308e97903a797b2f30a903b9459de27ee681004e79e87d6bf4a44501e1dad6e8,1,5,2,819,1659,8192303770380468,711262,711262
2021-11-25 08:25:58,2021-11-25,08:25:58,1936697,19433119,336,7ded3d5ac07f99436e13a0fc8994841adb7e83db743f9e3f773852a663a07094,2,1,2,225,573,5222766340262471,711247,711247
2021-11-25 07:52:48,2021-11-25,07:52:48,1550000,17496422,6710,d25fc5b6c0b3d46dff11917e01e11e08a666eb54069d142e72d9d6aed18527c3,1,2,8,704,2006,6866384520075995,711241,711241
2021-11-23 20:08:30,2021-11-23,20:08:30,2923465,15946422,1001,7d9f676034a37bc717d060877c1a72be13648a8c1083f0c3b03bb7874dd70e9f,2,3,1,490,991,5596354897311463,711029,711029
2021-11-23 19:37:02,2021-11-23,19:37:02,323968,13022957,336,9370e31c04451474974a19bd527f3e60dcf41efb2d2d205a72b5c846ec2354c3,2,1,2,226,574,6872516715403542,711029,711029
2021-11-23 20:10:36,2021-11-23,20:10:36,338238,12698989,450,4e92bd27715beba2b8c7b3368a7b3d0f0c2aaa01f0a128941928c4b796e2177d,2,1,1,195,450,4401329255938181,711028,711028
2021-11-23 15:04:03,2021-11-23,15:04:03,167919,12360751,338,9f18de113c2300814b48a7ce346a25bb9d56c0d9af190846bff166b148b7c6f0,2,1,1,195,450,8471560613932254,710989,710989
2021-11-23 14:34:57,2021-11-23,14:34:57,98408,12192832,338,87d70dfa81ecdf4a09083b8db73b766b55d887c076130460136a546e106751dd,2,1,1,194,449,7786934119025293,710988,710988
2021-11-23 14:32:24,2021-11-23,14:32:24,140732,12094424,1060,43fa094cf243dda19ab0391dd4f87efad12e2b47e64026deb5b786a97c2bb94a,1,2,2,373,844,2629093087850710,710986,710986
2021-11-23 07:46:15,2021-11-23,07:46:15,355918,11953692,744,ac0e5ef5be7902f3a534f730e55fb96fde6ad1be03554fe2c0cf62e9c42c8a1c,2,3,1,492,993,1004153029340249,710943,710943
2021-11-22 18:29:11,2021-11-22,18:29:11,10658961,11597774,4960,5aaadbcf02f8d0cbf69524bc1204c80608841f9fadb99bc3dbda498e1300fa86,2,6,2,970,1933,4749065639283003,710869,710869
2021-11-22 10:01:15,2021-11-22,10:01:15,-587183,938813,72367,2b2ad4c7c77c4a43578321e396396cc0e44c51c905a7fa379ee5d73ecd638a5e,2,169,2,24994,99976,3326351132580604,710816,710816
2021-11-22 09:08:52,2021-11-22,09:08:52,255551,1525996,675,2e74d17e96d1c8c28e8942d89fa4211feec7bfbc72fc072bd6e2d75ee8b0fa9f,2,1,1,194,449,5628769877089020,710811,710811
2021-11-22 06:58:07,2021-11-22,06:58:07,587183,1270445,450,bfa7e6982d38763c2d0a73d2a87f9bd03683229858c9cb3698e7ee6583f4bd63,2,1,1,194,449,3509360071065052,710808,710808
2021-11-21 23:22:37,2021-11-21,23:22:37,163545,683262,744,4383e54579d108da8443542243b9fe61a1d9779f779dbf99358932bc955c1aff,2,3,1,492,993,8975638001583697,710755,710755
2021-11-21 22:01:11,2021-11-21,22:01:11,-789760,519717,37696,c47a20a4f7cdb33945f67cfc97ff296dc1ab0ebc657f9e8501f28e8ce55f190c,2,120,2,17767,71068,425699923038686,710749,710749
2021-11-21 15:15:36,2021-11-21,15:15:36,132327,1309477,2496,50e8050cceeba5b0b8a3b7f743e18bb2c56e15c7188f88a52cedba9e1b396a05,1,5,2,819,1659,190521049077597,710710,710710
2021-11-21 13:27:53,2021-11-21,13:27:53,789760,1177150,12400,80aa075491725396cc2fc6b8aa71892c3d496704a512c40e87aac201c64543a2,1,4,13,1270,3472,5709114147616853,710703,710703
2021-11-21 12:59:41,2021-11-21,12:59:41,214222,387390,563,8b9495117b77b1513aed8958f136e7152f0e8de9c56f8b66af288736bdbb8792,2,1,1,195,450,5155573375357157,710701,710701
2021-11-20 16:33:07,2021-11-20,16:33:07,173168,173168,34458,7d6824ebaf1b5b0940367f78f2fa64b23be43a02e15b20e593494592f61e1efa,1,1,97,3315,12930,8800232814037161,710586,710586
2021-11-18 20:01:23,2021-11-18,20:01:23,-1727198,0,34951,ada448b58220758f09fd9330b8a1a22ed89eceef1e23ededab0fbd37ff6ebcc1,2,76,2,11359,44884,6816481927428001,710328,710328
2021-11-18 17:40:12,2021-11-18,17:40:12,1727198,1727198,19731,c5fdd279a2c47031d5a2166368fb99da22bd167c837d486b296df0cd42bf4ad0,1,1,99,3371,13154,7328622559477261,710306,710306
2021-11-16 10:01:38,2021-11-16,10:01:38,-493608,0,186822,371cc4b9553da81124c8149d9ec09bd3a0c60c7c527dc760b3202ea86e1a2133,2,596,2,88660,351574,1798952652703172,709964,709964
2021-11-16 07:23:02,2021-11-16,07:23:02,493608,493608,1080,d82001fc840fc2462645847f06533af5ecf07f1c53828e95ea347e89584d1a7c,2,2,2,374,845,4366477076541382,709944,709944
2021-11-15 20:02:31,2021-11-15,20:02:31,-308377,0,89073,0eb4b20bbdf06cb846845ee6a1b2392f4ba51b6d7d06ff60f3abd1c5b0d2228b,2,258,2,38132,152528,4895413758376501,709898,709898
2021-11-15 16:04:06,2021-11-15,16:04:06,-137700,308377,212811,b3795510d63125087b9e259794990c46c45268374ce312a78037c8e1a7dd74d0,2,643,2,95640,379344,7334411313625350,709866,709866
2021-11-15 15:51:39,2021-11-15,15:51:39,-549120,446077,109389,c513b0c17074e2c0db9d9cfb038e6eb8cd80236da7da774066cd30d22af7dc7a,2,330,2,49103,195095,4322862661518873,709856,709856
2021-11-15 15:51:36,2021-11-15,15:51:36,-900358,995197,173670,51a82d96fc90c7af3f44eb4e2467b4edfebef493b9740df54620aa1bd40647f3,2,524,2,77904,309717,8559564249331012,709856,709856
2021-11-15 15:49:19,2021-11-15,15:49:19,-1460055,1895555,176931,6cc316b23399d6183e179ffe8ea12ac71b264f9c3a3b5a86f38d26417a205e69,2,535,2,79587,315462,3707295767209169,709856,709856
2021-11-15 12:02:14,2021-11-15,12:02:14,-406891,3355610,36338,fd9d51d676dc66644d1e5bfaaf7a60db38ceeb4ab0f635c98c3c95fe24bfcc15,2,105,2,15572,62288,767011980300967,709833,709833
2021-11-14 16:07:14,2021-11-14,16:07:14,604027,3762501,894,5725680b49d0a748ad8e51893bd182243c5849f8789964883a42565a551a3cd8,2,1,2,225,573,7608084846037704,709697,709697
2021-11-14 10:02:27,2021-11-14,10:02:27,-1299366,3158474,15927,4e25be2229b340e25d3225a9c8ee24342491460154004bb41ec59ac5cd37d756,2,53,2,7895,31580,3055435334071128,709660,709660
2021-11-14 07:51:24,2021-11-14,07:51:24,1299366,4457840,336,8d7f7b5ed9db9fdf869a5d85f052b87f1fc4a847fe4bf8ee1b69fd5d88ecd7c6,2,1,2,225,573,6996182036103085,709649,709649
2021-11-13 10:03:18,2021-11-13,10:03:18,-1094692,3158474,65193,d5566b517429d456dc2aedd5cf07e4ce1165ab78a75410575cbe830d207861c7,2,61,2,9069,36276,7015086115893367,709499,709499
2021-11-13 08:33:05,2021-11-13,08:33:05,1094692,4253166,12986,8d556aa11a9baf8a2f87beb50b26cbbad5b6abafde652b094dee3ccf2b7ea080,1,1,38,1432,5398,4525657597536157,709490,709490
2021-11-13 05:27:33,2021-11-13,05:27:33,266612,3158474,870,3c017021d120430c8d300cdd34f1480c2452fdd431faff5f46848e7963201f23,2,3,1,491,992,1235731019149776,709473,709473
2021-11-12 20:03:27,2021-11-12,20:03:27,-617102,2891862,142922,aa375a1ec94515e3ae41ec785d8ab848d5d247f382a458910ede392926efa35a,2,114,2,16894,67576,3189124429588283,709425,709425
2021-11-12 14:19:59,2021-11-12,14:19:59,234354,3508964,3480,0951ce65ddab6f98273c175d1b6a3bf02e5609da78b3bef81010ef706df9672a,1,4,2,670,1387,1492033750310370,709386,709386
2021-11-12 10:03:16,2021-11-12,10:03:16,-1508017,3274610,562205,8479011a6e4d148ba56a10e19e13eb6ee20eb2efa09a76d565b890aaab183c4f,2,529,2,78674,312467,2787824977138199,709358,709358
2021-11-11 20:03:14,2021-11-11,20:03:14,-1573888,4782627,84183,89950c0fac481f0a79e02e9312356b216201143701a05299336eb6da14ca2192,2,71,1,10614,41919,5141562302093005,709282,709282
2021-11-11 17:32:34,2021-11-11,17:32:34,153586,6356515,2120,24bea2dbf0885bdc2eac39d4695d6cfaaf44d0e4650e4458059c22591e058b3f,1,2,2,375,846,2235722204128339,709266,709266
2021-11-11 15:54:52,2021-11-11,15:54:52,617102,6202929,3492,dab4e0ed8275f5bd5a7a1c1a6b41e49a1327765dfe8798339fb0736dca4b81cb,2,3,1,492,993,7160197848870518,709254,709254
2021-11-11 15:35:30,2021-11-11,15:35:30,1573888,5585827,2514,765b417abb4791135e388dfd50c99627563f7cd98922deba879ad3c017083f64,2,2,2,375,846,3527100207733363,709252,709252
2021-11-11 11:10:17,2021-11-11,11:10:17,-1038619,4011939,61323,f9e9513199ade12ea9c6e5aabd208ad4a1a8b1ca2f13655bd1be7ffcfceaf8f2,2,49,2,7377,29034,8548829064302583,709220,709220
2021-11-11 08:55:51,2021-11-11,08:55:51,308377,5050558,1584,c8906970d12ebe9a4c77eeebd403e9a472c22e130635c49ad3282775fe4b86c6,1,1,2,225,573,6984963292308709,709204,709204
2021-11-10 20:59:42,2021-11-10,20:59:42,154554,4742181,2544,7590070b05640709c233a2d319ce6cb52e9a812d3156034ed490e8ca06cb9a5d,1,2,2,375,846,3293421202136338,709120,709120
2021-11-10 14:33:06,2021-11-10,14:33:06,482096,4587627,1006,1cf2bdb5d06ddb2ec921e1ecf5e4eaef9943b3cc8c1783954a0118eb0c37fad8,2,1,2,226,574,7634213664547584,709112,709112
2021-11-10 16:13:27,2021-11-10,16:13:27,240915,4105531,6806,4b0c659d87a05e761624c52447011f51014bf1ac3c3f8a63b9688322cb9bfc4d,2,6,1,934,1804,2743914908110957,709091,709091
2021-11-10 13:27:14,2021-11-10,13:27:14,-2508641,3864616,96995,55a842fbf6dbd1f921efbf41128ad0f170bf6829e36e83b78b6e79baacb94c85,2,85,2,12611,50444,4690066531634989,709075,709075
2021-11-10 07:58:41,2021-11-10,07:58:41,1062435,6373257,1953,b9ccf5bcf538e4fa472a42dfaa04d9c0d2053298f93b6990f8b25756eb0335b1,1,6,1,938,1808,6234920228408054,709043,709043
2021-11-10 08:03:09,2021-11-10,08:03:09,-5104507,5310822,35355,ea49595678337807d82ccec988697c665d383e5e815fa0cfbc2f3576da76bad4,2,31,2,4703,18395,7484714337093285,709043,709043
2021-11-09 22:52:26,2021-11-09,22:52:26,1038619,10415329,1788,8a7b51ce11d605bb3db8ae2ad76df9aeb0304e68d5c046f0bde79d669a9751ea,2,1,2,226,574,8244357015327676,708985,708985
2021-11-09 16:20:37,2021-11-09,16:20:37,137700,9376710,25579,fdeac3233ba5f5cfffc922d6f0375ad203a3f153b8cd79946795bf27f9fbd419,1,5,30,2643,6774,908881637472242,708947,708947
2021-11-09 15:24:46,2021-11-09,15:24:46,296017,9239010,5861,33204e9fc88db4866a3960c5aff68a8314223982b88898a529869ac07070b43a,2,4,1,639,1263,2065492958778192,708942,708942
2021-11-09 14:25:04,2021-11-09,14:25:04,222369,8942993,4480,837f3ae43b39718957d0bd84ae674a34729d4f4ccf5d6e082c7d8cd192b75bc8,1,3,2,524,1118,7049479917810063,708931,708931
2021-11-09 13:00:32,2021-11-09,13:00:32,5104507,8720624,22032,f90d9b8db53ae4967b01bfd0b9342c5e1662ca337f0199611e69fdccab69011a,1,1,36,1486,5179,914987845001133,708918,708918
2021-11-08 21:28:43,2021-11-08,21:28:43,406891,3616117,1565,ce288caddfbc01d45d0bc65f1f108030a772ea06337f56402072724f96589431,2,1,2,225,573,1744422757330510,708850,708850
2021-11-08 15:03:31,2021-11-08,15:03:31,154619,3209226,1484,25994482a4a96d313a1dc428905a978014602a18eb2a2d730ad1c7069eeee95c,1,2,2,374,845,3269113615014138,708802,708802
2021-11-08 15:03:20,2021-11-08,15:03:20,244838,3054607,1341,bbb690bb843f11c749861348bc3c761ccc27a59dd31f6c9ee0275313c3f89d00,2,1,2,226,574,21711468784228,708801,708801
2021-11-08 11:00:15,2021-11-08,11:00:15,1446206,2809769,894,d24084bd8969da157a644b69c778e3a42bc32b0d29c4d13a5fdb799cb7fe4310,2,1,2,226,574,572295113576251,708780,708780
2021-11-08 11:00:22,2021-11-08,11:00:22,310442,1363563,894,872ac36a7e5e95c67bc112c0c23e48d28653f60077142c1e28f2f0584934b001,2,1,2,225,573,59401699008030,708780,708780
2021-11-07 20:03:09,2021-11-07,20:03:09,-727507,1053121,77048,5b8bd40519bcc831e0e0ed7d2eb25491355c17bc44c49f434a662da63c9688f1,2,180,2,26629,106516,8498206028907948,708678,708678
2021-11-07 17:03:59,2021-11-07,17:03:59,727507,1780628,978,390f74bc1c75098645b241a1616c36bd14946af0823f7762377d542fd6c7fb9f,1,3,2,570,1302,5628919625935503,708658,708658
2021-11-07 14:03:06,2021-11-07,14:03:06,-967506,1053121,17109,a511b67e6f00afa0872d7e12305200f337d6a872eeafa7536e6e886d099916e0,2,57,2,8480,33920,7884405165895949,708633,708633
2021-11-07 07:08:59,2021-11-07,07:08:59,967506,2020627,718,d7bcf27ce3c4062dcac9d53f2873b708b5f86db4a4240e5f382fefae8ed52c72,2,2,2,374,845,4017180384812517,708597,708597
2021-11-07 06:52:08,2021-11-07,06:52:08,323217,1053121,12133,ea58ff3e4c7c7494437ca89dbc2386e1412c4d94d3b9355de125156b7731de6d,1,1,39,1409,5306,3865634562466468,708596,708596
2021-11-07 06:25:51,2021-11-07,06:25:51,402839,729904,948,b0696db179b089cdd6c876159e0d2d1a741c2f2fdaa581688d22675826eb75f9,2,4,2,670,1387,8777115252755684,708592,708592
2021-11-06 21:46:51,2021-11-06,21:46:51,327065,327065,2800,b2e5f1e709b4afefbe8e0fad688e507467d4d99da18b5f0e9ebbc753635de9d3,1,3,2,523,1117,7455975924201719,708537,708537
2021-11-05 11:33:24,2021-11-05,11:33:24,-3376214,0,109975,4cd3902da0ba29deb8ef06269b73231d94b893a022587f207301901820eb0860,2,87,2,12905,51620,3378925464130048,708314,708314
2021-11-05 09:30:26,2021-11-05,09:30:26,-733601,3376214,287332,f33b0e31601ed4bcea65541b49d1ad2ab4ed58839ec0396ecbf3827cdc3ca12f,2,212,2,31619,124874,1675825834332254,708296,708296
2021-11-05 09:12:06,2021-11-05,09:12:06,2888542,4109815,16073,5a45339a5d1b1845b4cd6495e3b262f20ed1a88b7ac8fc7b975da0af658114a1,1,1,43,1591,6037,5667502154970123,708294,708294
2021-11-05 07:56:24,2021-11-05,07:56:24,250471,1221273,3754,0d36dfb27dc11475632158150114fc77fefdd0b7e6cc67cb670439bb18812052,1,1,1,191,764,2889585866008352,708290,708290
2021-11-05 04:47:17,2021-11-05,04:47:17,483130,970802,3480,4b24b6fafb102a0c5a088933ebe26f983fdd55f8c6faee76060db3650bab32f5,1,4,2,673,1390,8627134938265185,708275,708275
2021-11-04 14:01:15,2021-11-04,14:01:15,-1430639,487672,88361,2216198f02e2f814facb01fd9989b3d1a2d9dff9b2fcc9505127d740c5e000c5,2,110,2,16432,65074,6931441974254308,708184,708184
2021-11-04 13:48:36,2021-11-04,13:48:36,487672,1918311,1696,47d6dd62324ec12984868d0b0e6193fe91dbd62c40d97752b9fa4e0679833ae9,1,2,2,373,844,8206000739895775,708180,708180
2021-11-04 13:36:58,2021-11-04,13:36:58,1108570,1430639,1976,65a65e483ff6119d8c87bb681af19cd8c342199c1e0d6a7327d8d406c9ba173c,2,2,2,374,845,2114323700832923,708178,708178
2021-11-04 04:01:37,2021-11-04,04:01:37,-3253530,322069,51222,8bbd291256cda8c94fe9eb1b2ce831e674f0fa04c5140ff3c000541d752db710,2,68,2,10199,40268,588125686704768,708122,708122
2021-11-03 17:58:13,2021-11-03,17:58:13,322069,3575599,1008,42ba78840e54c9ef04827e28a48a0b86e0ee18067e724c057959455a159803b8,1,1,2,226,574,6474418430363819,708065,708065
2021-11-03 16:57:23,2021-11-03,16:57:23,3253530,3253530,1796,38cadc2b60fa7766888844ef32489f58e7ea71a3502a7a82c87ef0acfb44e975,2,2,2,374,845,4148631845576207,708055,708055
2021-11-03 16:02:29,2021-11-03,16:02:29,-318689,0,28859,8512e7b4ae331ce6c8bb53f8a5205491522500cd07c00ea2a2c02c4dc2d77ad9,2,39,2,5890,23116,7651892130325912,708049,708049
2021-11-03 14:03:25,2021-11-03,14:03:25,-476368,318689,52494,f5940a3d69123dafa77170bbab9971b132ab1b8cc07ed10d2660b93b196c0489,2,65,2,9656,38624,4820866766960428,708033,708033
2021-11-03 10:51:55,2021-11-03,10:51:55,476368,795057,1908,d4b0d7df07529e6465ed65d129994688ae718a4d9d16b0d3a5f07fe026ab1eb7,1,2,2,374,845,6442955147317246,708011,708011
2021-11-03 08:49:54,2021-11-03,08:49:54,318689,318689,1296,99e079cffc76533bc8ca1e706230d9a4973c9310cb07cec02ea033dbf11a684c,1,1,2,225,573,2688320395765364,707999,707999
2021-11-02 12:02:09,2021-11-02,12:02:09,-3659731,0,98184,a79a991d581ba8b12b82a2572b351b985c90aa8f3cef4f4af2aefbe920f1dc04,2,165,2,24613,97312,171103513034613,707862,707862
2021-11-02 09:34:21,2021-11-02,09:34:21,3330315,3659731,336,86fa735deb5a66830dcd0fb4aff55aa2832de6e6c201f8bb153d520eaa8eb441,2,1,2,226,574,2311799789701703,707848,707848
2021-11-01 19:55:25,2021-11-01,19:55:25,329416,329416,720,6a143cf9113ab7c862a25e76bf0d51f8e741007b02bc2ff0f24308a6b3714f69,1,1,2,225,573,3705277789815048,707762,707762
2021-11-01 18:02:13,2021-11-01,18:02:13,-162563,0,94809,175974202806a11d522a7d2fadfb4b15f9aa005cfe02a79c43ac9fd5fe451348,2,159,2,23520,94080,2535923709031413,707748,707748
2021-11-01 16:06:08,2021-11-01,16:06:08,162563,162563,11102,2f320c71b3eb9cfee7d3dee70965172990c14a7ab357ace60e0ec10dd4494b9c,1,1,79,2713,10525,5499109603653665,707734,707734
2021-11-01 10:05:31,2021-11-01,10:05:31,-803939,0,47788,cc76762e97dd00de8faa6e52d9f2f9b383f4349a1919bab27d15f85e3edc76da,2,107,2,15984,63288,7686529154277122,707698,707698
2021-11-01 07:53:07,2021-11-01,07:53:07,803939,803939,6261,e138c3a0d590109cf410c499dd566884333d08d63cace8920b0b0f18a083944b,1,1,48,1701,6474,2659239537607137,707684,707684
2021-10-31 20:02:49,2021-10-31,20:02:49,-329772,0,137916,792691ed0b4f23bf53f69df311db6515316fade3921247705f40f3c03ab751ba,2,463,2,68897,273236,6555524134346344,707617,707617
2021-10-31 10:56:57,2021-10-31,10:56:57,329772,329772,720,8704b27657d318a026f214c326210256f10bc781032b4b4f68723b6ab768f38e,1,1,2,225,573,5029634721531758,707564,707564
2021-10-31 00:04:42,2021-10-31,00:04:42,-330953,0,76405,fc45d9f01297d6186b6c5b24d230a0614b3a7cb186bda6c2cf52aa9fbcc00106,2,171,2,25300,101200,211347146274122,707497,707497
2021-10-31 00:04:44,2021-10-31,00:04:44,-326076,330953,207382,f5896f1e8afc098f1aad6d2f43dfdef4e56a922d3d61e76711004488dc7c83d7,2,465,2,68659,274636,7582711536486528,707497,707497
2021-10-30 13:03:15,2021-10-30,13:03:15,326076,657029,720,bc7759a887aa1d86926fcdfa657a6746de4b575a753cefca9955ae1a7b06fee3,1,1,2,226,574,8021765437740490,707429,707429
2021-10-30 00:01:02,2021-10-30,00:01:02,-1639225,330953,52764,3224df9850311a5fc1b0f0d6190b898a8d2f74ed189ef59221721aafc4110a82,2,92,2,13753,54412,4575352300364622,707340,707340
2021-10-29 16:01:04,2021-10-29,16:01:04,-393048,1970178,144529,33d73a47be9b0e526a049392f067317b9c1a33d951d135b56ce17f1c59af537e,2,210,2,31307,123953,4444732455620604,707286,707286
2021-10-29 14:01:03,2021-10-29,14:01:03,-1860383,2363226,37857,8e7e06441cbfe0afd3e5a90aad757629316ce7b8fe92a5eb668ec3511a59bee6,2,60,2,8927,35708,8118566818297969,707269,707269
2021-10-29 13:20:09,2021-10-29,13:20:09,1860383,4223609,1983,30dc5d5528c4901601ee68af87ccfece1a9b9e98136225d2925b19775aa83a9b,2,2,1,342,720,5461639517102891,707264,707264
2021-10-29 09:33:09,2021-10-29,09:33:09,330953,2363226,7454,a0c39ba1be84ef04d0c0e6c1c966cd168508343bb8fc71fd0fcfdfe548571af4,1,1,51,1846,7057,8588607063112697,707244,707244
2021-10-28 20:31:01,2021-10-28,20:31:01,1639225,2032273,980,684d26fed1e85cb106b38d584983dcf645a6d08b783e1a20161dd81b393fe9c7,1,1,2,225,573,7033747264469763,707149,707149
2021-10-27 14:04:44,2021-10-27,14:04:44,-401693,393048,193606,1b89d62a16eff10a2842fca0716b9aa517dff63efd2d19acc266cd6d6e026825,2,563,2,83812,331633,1316116723775916,706946,706946
2021-10-27 12:04:40,2021-10-27,12:04:40,393048,794741,8228,0c86481a9bbe1d3a343967b0e1f7def5fc64fd5b444dee3b4609a560aeeabb24,1,2,2,374,1496,1292464472986785,706930,706930
2021-10-26 13:01:08,2021-10-26,13:01:08,401693,401693,8667,b33fbd9a90b839613dd319a0383235bb962f3d168e3bfe3da95bc24bd1423c25,1,1,61,2138,8225,1310103976900683,706795,706795
2021-10-22 11:32:54,2021-10-22,11:32:54,-48952,0,563270,82e45ecd50bd985466c0baa7b939f7cd00cf4e43598d8545149265801218039a,2,379,2,56552,222503,5418818542242994,706140,706140
2021-10-18 22:02:07,2021-10-18,22:02:07,-92677,48952,392910,bc7a1ba624ee815d0dd8d224ae3eb6d7e5e5e9be63cc642b9f45314193cca68e,2,525,2,78142,309706,5019105533371944,705611,705611
2021-10-18 18:02:01,2021-10-18,18:02:01,-165522,141629,95807,ecee7ac91a1c91bd71adb9bb0c31207a91593bbaf4ab0d2100cbf7ede7af2bec,2,130,2,19243,76972,8309516126764793,705595,705595
2021-10-18 16:02:20,2021-10-18,16:02:20,-993645,307151,266037,b82c13be1ce7da2535653ec9ae1dd03f13afc2afe0b8cd512a3539e04cac4dec,2,427,2,63546,252255,8314187115398950,705579,705579
2021-10-18 08:03:04,2021-10-18,08:03:04,-177051,1300796,96339,c6ff32c62e279793beb69529473feb8c994d44c8fac9615404fafcd790c32a53,2,279,2,41537,164984,2926180313005983,705527,705527
2021-10-17 07:51:09,2021-10-17,07:51:09,993645,1477847,17530,03b549d9dadee6f240a5b38eaef2e3f0b6fc24fc6797bac92ebd51cb468141f0,1,1,42,1508,5702,8453252238109239,705357,705357
2021-10-16 15:23:07,2021-10-16,15:23:07,165522,484202,34582,86026d6a6b5c68c15989f073586cdee985022fe259d86f2ba12422eb6c5aa38c,1,1,79,2736,10614,4948263188653124,705265,705265
2021-10-15 17:39:00,2021-10-15,17:39:00,48952,318680,2124,bcc9ebed3177611e8714e5505ff5e86e50d083f712d563b53cfba314deab5c53,2,1,2,225,573,2933039537755263,705147,705147
2021-10-14 14:02:09,2021-10-14,14:02:09,-175593,269728,108498,831347d07c2506713897e36487953fb516b48fb01b8c03892cd2531da645a797,2,315,2,46917,185760,5335829883103866,705036,705036
2021-10-14 12:43:59,2021-10-14,12:43:59,177051,445321,540,870e1063612bf2a2d9fa2616853cb33a11a38c22d720c1af75283f6ccff256de,2,2,2,374,845,7822880711477221,704974,704974
2021-10-13 18:08:11,2021-10-13,18:08:11,175593,268270,36107,b1f692277fd4ab1e2a6eefe7df5179b743304aa84c6f98d3bb6faccb8cdb3743,1,1,79,2714,10529,2365029942392205,704853,704853
2021-10-13 14:02:05,2021-10-13,14:02:05,-1201666,92677,97179,418bf27596c6695bfe1489273f91ede8a326ea2c05e395be0f6850564ec8e633,2,59,2,8856,34920,1826121474296333,704817,704817
2021-10-13 10:27:42,2021-10-13,10:27:42,1201666,1294343,2694,1c988e0480e230c5369a47915cbaf5a47a700d0bfa9824fab2360b9d3832a701,2,2,2,374,845,58163639591270,704796,704796
2021-10-13 08:41:16,2021-10-13,08:41:16,92677,92677,1565,e66e0561f0b69974aed1150ab4382e1a983d2e94be616453ff39017999a82f8d,2,1,2,226,574,4967546611507239,704784,704784
2021-10-12 04:07:56,2021-10-12,04:07:56,-539676,0,1135231,9a72df9618ea45042058ffc836aa373d21ea8c5d88e651aac1a42a80cdafdbe0,2,559,2,83155,329977,7911492862084436,704616,704616
2021-10-11 08:35:42,2021-10-11,08:35:42,539676,539676,1230,55026bd0b4b76d1e39bc3ea56c11dd0bcceae10011b184826214eaa0ced78ef9,2,1,2,225,573,8780540842089794,704506,704506
2021-10-10 18:02:04,2021-10-10,18:02:04,-449575,0,525520,5280ff0c019f61f4f1030a4481e414ebfa037ed3943f924e1296830fab69066d,2,320,2,47639,188951,3835977921589362,704412,704412
2021-10-09 20:09:25,2021-10-09,20:09:25,449575,449575,3405,c810e273e0d46c917448e34dad7362d02698cf17a5acb4a8257d4c4974d78197,1,1,2,226,904,5330685481527695,704268,704268
2021-10-09 06:02:35,2021-10-09,06:02:35,-491400,0,137419,ea9a18b7964f7cd388e298a624eab4411ca6893adba210401243446fbd3a07c2,2,67,2,9958,39832,6826761793693832,704178,704178
2021-10-08 08:03:16,2021-10-08,08:03:16,-1233153,491400,501504,a2bfa17619c6a513957e0074a583c077040b2555fa968abec658175cd7f84928,2,246,2,36630,145455,1417541522785003,704064,704064
2021-10-08 06:36:23,2021-10-08,06:36:23,921782,1724553,7995,8e38c243d97e7ef58bd2b6fca36bfc5ef4292fcfb6bc9bcd5bf0998bec535f1c,2,1,2,226,904,998264175424318,704051,704051
2021-10-07 14:24:09,2021-10-07,14:24:09,311371,802771,4294,a741e1c45f91eb42118561877950af737a9488f824ca0687826c0feb754c8dfd,1,1,2,225,900,8921066080395757,703960,703960
2021-10-06 20:29:15,2021-10-06,20:29:15,491400,491400,24876,bf7dc7957127b2cf7d8f789fce7a2d414ba0589c9bcc1036850af2af61b5c8bb,1,2,34,1469,5225,6607062749806145,703866,703866
2021-10-05 18:03:09,2021-10-05,18:03:09,-4661870,0,59139,a36a0098e486ef9fbd4cba0b1c46d1ff4376524e501c3955dbf65c92c738cb43,2,80,2,11883,47532,2385283520809886,703717,703717
2021-10-05 07:00:26,2021-10-05,07:00:26,4661870,4661870,9685,89aa6791a99c2edee209654bc59ea298905c2e7b6a02260339925cb6d4ef93c1,1,14,34,5725,12289,6810916097543058,703635,703635
2021-10-04 12:05:49,2021-10-04,12:05:49,-312724,0,153560,1034e2e64038063b256380ba9e514326b05e2db9ee5e0469af5ab23141abd1e3,2,313,2,46634,184637,8015669147088459,703501,703501
2021-10-03 16:37:26,2021-10-03,16:37:26,312724,312724,336,4f5658f29a1dfbea1dfc4fb950a6fe296ec81402a57da744b01cd993a83d488c,2,1,2,226,574,4935740799744803,703388,703388
2021-09-29 22:03:23,2021-09-29,22:03:23,-601555,0,24140,c7abb4ccec22d3a42723bdc4160b5c6effb7aed3ec7724870e255616ee61a1e3,2,45,2,6828,26211,8009032711457476,702785,702785
2021-09-29 12:03:37,2021-09-29,12:03:37,-471529,601555,41031,52bf07b4cd602f2bbf898372fe6e0abb76f858190b96d14f8ee9796a61757090,2,96,2,14362,56833,5082005761773373,702769,702769
2021-09-29 10:47:11,2021-09-29,10:47:11,601555,1073084,6235,78d2ca173670b9fe1136daedd9897c217c127d45335f68085c360b0b25bf12f1,1,1,45,1630,6193,8482010194600294,702722,702722
2021-09-29 10:03:29,2021-09-29,10:03:29,-1378805,471529,99073,a5ea27087bf5d4c9a6c133f9aeff3f7e9a8c86140dbde6f41550a4113cee47fe,2,182,2,27142,107377,8946716577510538,702716,702716
2021-09-28 15:26:07,2021-09-28,15:26:07,471529,1850334,7071,bef0ca351d67142e28f84a4d4943810c30f3da41e02f04b948d556b60f9f82d2,1,1,69,2430,9393,7406670598032090,702599,702599
2021-09-28 12:39:08,2021-09-28,12:39:08,1378805,1378805,5153,1c7061f201c0bb8f8ca552e3a66a6962bf576663bf8b387652c02b7638e25791,1,1,60,2086,8014,5113812593067384,702584,702584
2021-09-27 22:02:31,2021-09-27,22:02:31,-3367354,0,9332,4ae2496c79d3a14d38f3a1b7796cd7cc97efbfbeb1ede9591f4d4b2f3fd05eb0,2,34,2,5092,20368,6205480550918505,702489,702489
2021-09-27 18:03:20,2021-09-27,18:03:20,-746497,3367354,74832,8fa0ac7bb2c4c0c4123693f042f1a04cebb1a9665a54c43c4045b7c84641f598,2,291,2,43413,171171,5381732146157288,702464,702464
2021-09-27 18:59:11,2021-09-27,18:59:11,1509240,4113851,336,24e76d20efa0b3164b900c89b7ca3863360fecd22bc6d17cbc7144d81b865d44,1,1,1,195,450,2405391123810446,702463,702463
2021-09-27 17:55:14,2021-09-27,17:55:14,1858114,2604611,540,0610e289e70459ae446fbf13a34462abcb2b53ac710df25166913605681152fa,2,2,2,373,844,8807372361344722,702460,702460
2021-09-27 16:51:19,2021-09-27,16:51:19,111679,746497,541,b520e95a35e4efc8d1f7e20089786ce4dc7670af0e07bc564582b215939c46e0,2,2,1,342,720,7891004134962768,702450,702450
2021-09-27 02:05:50,2021-09-27,02:05:50,-1119176,634818,31061,7bac6da538c38c98f463c4dd0c1284abc90604558ff6a83776ebe5317dc3b1a5,2,132,1,19693,77728,5829853041802429,702361,702361
2021-09-26 17:57:55,2021-09-26,17:57:55,1119176,1753994,2052,2b270b721c5e4d52f8caff399defe86c33487e0fbe100ddda0b79f1c2c57a162,1,2,1,339,1356,3470242936493046,702307,702307
2021-09-26 07:14:08,2021-09-26,07:14:08,294086,634818,3061,50b79d59a4a92a7eabba8ca065399faa46d885a57330b4f6f140f4d9e56af214,1,1,36,1324,4969,737005058866824,702248,702248
2021-09-25 20:04:51,2021-09-25,20:04:51,-497674,340732,166034,43a96c6ed7ab86689ed1f5b4fe18dd125eebdb6e8da40b390ee2865bc4ddedc6,2,556,2,82735,327988,6999197765824732,702185,702185
2021-09-23 09:46:20,2021-09-23,09:46:20,497674,838406,29423,163243415a9be21ad00e8c2b7a5019702a85c0ff7292534a685a59c6974e58e1,1,19,35,7408,15241,7928620542118699,701809,701809
2021-09-23 08:14:46,2021-09-23,08:14:46,-1239549,340732,123784,dc31b38f8b183ca8798cd414c2c1248dabce38a9b3e5650edca7da5c1e8c7c18,2,109,2,16308,64260,861542585965396,701799,701799
2021-09-23 06:40:53,2021-09-23,06:40:53,-198303,1580281,615614,bb044733e6a076d2804b8249c6bbfb4f62cd448e5e533014de116ee185244a5b,2,560,2,84418,319684,3211967950761410,701785,701785
2021-09-23 04:01:52,2021-09-23,04:01:52,-784380,1778584,28170,4d01cf4ab9079235bc18b1e683ff1510e456bd2516743bfeb4fec7e42c9d3f37,2,25,2,3835,14623,1943883501836543,701772,701772
2021-09-22 22:05:05,2021-09-22,22:05:05,-1186506,2562964,702995,5b969498c8c956fb133edaa9a25ec7b608532f251abe1273497333dece2c628a,2,628,2,94042,364372,4868936421852782,701738,701738
2021-09-22 19:59:32,2021-09-22,19:59:32,758431,3749470,19002,bcc00f16950b0d0c69cbf15488cb9dff8cabbfb8e0195b43d4d8981b80c714c6,1,1,67,2334,9009,6969361558631195,701722,701722
2021-09-22 18:46:52,2021-09-22,18:46:52,198303,2991039,2123,92cc59a7cd762a5d20bfd3b5084db650a15d0a300bbe70902b6ce5c5a1aa574c,1,1,1,192,768,2686061075020973,701719,701719
2021-09-22 18:05:35,2021-09-22,18:05:35,784380,2792736,2558,daa4e0c948f8a6ccf4f5232a828aee3a55a687eb03e014d65715b1d564ebe8dd,1,1,1,191,764,7807758444967458,701716,701716
2021-09-22 15:23:21,2021-09-22,15:23:21,409043,2008356,17029,2b9c39d81e0cb15624378fa9db2c79e397bd309b50bcf223310ee1bdfaf66f53,1,1,60,2101,8077,2935691203296289,701700,701700
2021-09-22 13:22:04,2021-09-22,13:22:04,330000,1599313,11537,162c41e354f2e30f53f2c83e4c43d04b6c2bbf4948b665cf8598c3f0125e494f,1,1,11,523,2092,2789648944207987,701690,701690
2021-09-22 12:24:56,2021-09-22,12:24:56,500506,1269313,540,b1d191dd93e8aa04d343bab12dd645da063703b8fb41cda9dba404b3aa5cd5d3,2,2,2,374,845,7453226757939348,701683,701683
2021-09-22 11:03:30,2021-09-22,11:03:30,340732,768807,15089,d6612ab0221cc52dfd0efc70a6e9aad2a886ce74d135ab3421ad9a494cc75427,1,1,52,1873,7165,1383842380854101,701673,701673
2021-09-22 02:08:07,2021-09-22,02:08:07,-2025371,428075,236996,0dcca1c73beaf5efe051587e1ca9b6af7f91f51b0d3c748475990749bae36804,2,190,2,28319,112379,155153399881971,701630,701630
2021-09-21 21:02:49,2021-09-21,21:02:49,428075,2453446,2316,d161a319e4f812aa89e943fe4bcf894d76d817bc29cf0a4cd311dcaaad55e63b,1,1,1,192,768,2107534910774146,701599,701599
2021-09-21 21:02:49,2021-09-21,21:02:49,1189693,2025371,4509,223a76d76cb32f97a5a82dd709fcb1d5afc0dd5a91ac1f08e16f27d4821bed97,1,2,1,339,1356,5345427987268845,701599,701599
2021-09-21 20:11:11,2021-09-21,20:11:11,261030,835678,2486,07781b6a51cf8404919ca52730f800ebdcea44257680594f257cf13111474425,1,1,2,225,900,1311205770018351,701596,701596
2021-09-21 19:38:54,2021-09-21,19:38:54,574648,574648,4446,ff685d0ab246050c76699a64c36715b3d705aa5c05beea6b89dd876d3939dbcc,1,2,1,339,1356,7207741759009019,701593,701593
2021-09-21 08:04:44,2021-09-21,08:04:44,-367106,0,74515,63909eb73dbe25e3a6eabba342f4dd07ef6076409218311a0433dc1394490d57,2,113,2,16908,66648,3062866580241286,701533,701533
2021-09-21 01:09:07,2021-09-21,01:09:07,-602105,367106,41759,93dd22e42c98da44bdebdc393209171033d10c56759ceb0b25e41de62d343040,2,127,2,19036,74479,2258424896996284,701495,701495
2021-09-20 15:10:20,2021-09-20,15:10:20,602105,969211,2316,95f294dfdc24e2b8c3c08e6e60787c74598ca43e238741f193cd557f1c48f5b9,1,1,1,192,768,6542820094503609,701425,701425
2021-09-20 10:11:13,2021-09-20,10:11:13,-1295511,367106,11116,39f48c086e12dcdb33c034aa673d4b5a56e0c2fd6555e8150bcfc02ed69138c9,2,35,2,5237,20948,7079833666705433,701396,701396
2021-09-20 02:16:12,2021-09-20,02:16:12,-557608,1662617,76512,e8c0bf4fde252acc2be0f4ddb0efd6c6277b6b2be0fe1cfa18a99fc7c9e6e117,2,244,2,36347,144332,840288226046965,701342,701342
2021-09-19 22:11:16,2021-09-19,22:11:16,1295511,2220225,3437,54bf5d342216efe0f0b3a2a2e286f2ae1eec5d00edc5d9859ce4747caf701829,1,3,1,486,1944,1445918288088732,701319,701319
2021-09-19 18:53:04,2021-09-19,18:53:04,557608,924714,1351,fbe6a884f10c0f28744bf8c40ccbc1240a6d40ab820317f91f049ea0c453edc2,1,1,1,191,764,6858386189849536,701306,701306
2021-09-18 21:26:23,2021-09-18,21:26:23,367106,367106,1544,7175a99c9b912bbe070cdccb763acb9133d4084b5cc6956ccf1836137ada7b15,1,1,1,191,764,755894099011267,701146,701146
2021-09-18 20:34:41,2021-09-18,20:34:41,-5336026,0,53046,b8e87d9c44051ae19eb2a613c8d043bf4f6d2b0f571cc2d5581741e10e22cea6,2,63,2,9452,37295,5868936475977762,701139,701139
2021-09-18 16:08:28,2021-09-18,16:08:28,4974768,5336026,21152,42bdad9ea2fb6cb6e2d3b12b01eefa44f9ac00cbc42c2c6836f02f244228a209,1,1,88,3030,11790,338946072806910,701118,701118
2021-09-18 16:08:28,2021-09-18,16:08:28,361258,361258,1737,0fdde13c0abf06943f79be803d86acb33bbbbd104680a5753734ca37c4b96c55,1,1,1,191,764,3005614767143238,701118,701118
2021-09-18 12:26:55,2021-09-18,12:26:55,-2088275,0,94291,8ccc4009597deb9027dea5a0b20b526127ef1b9c58d34d20f381779933e282f4,2,112,2,16738,66292,8602975294664432,701092,701092
2021-09-18 12:26:55,2021-09-18,12:26:55,-86561,2088275,127274,0a91b79b232fef51bbcfda75f14ddb24e667cce4cf112260265a2108a3407cf5,2,152,2,22712,89429,8637248293635115,701092,701092
2021-09-18 09:43:51,2021-09-18,09:43:51,1850585,2174836,9961,3927ba496e0218025bfc8419c7ffbe29a58c96cd6ae908d35e3ca8fe7659276f,1,1,34,1263,4725,3910873452107015,701068,701068
2021-09-18 05:40:14,2021-09-18,05:40:14,-1572338,324251,19961,11d1230d370e6304f4c06b9ebfa4dbd20afcf4cf22d6100576f8eef984c1d159,2,20,2,3027,12108,3160237752139231,701049,701049
2021-09-17 17:26:13,2021-09-17,17:26:13,1572338,1896589,20612,d334396f460d363322937880ad17dea65ee931a17abf5cb8b4efa223e79194c7,1,1,69,2411,9314,7022109341807709,700964,700964
2021-09-17 16:22:53,2021-09-17,16:22:53,-1681723,324251,309983,7b4ea02b4c0de9877d3839b45d396a534273b69aef6d9e628bec39bbecd549db,2,324,2,48566,188174,7715525381023549,700956,700956
2021-09-17 13:58:34,2021-09-17,13:58:34,86561,2005974,904,4e5469ab85ce91418ccda8fa9f08191ecd3fd402d72694e93b9fbb080f5799eb,2,2,1,344,722,8289402340054899,700945,700945
2021-09-17 12:55:19,2021-09-17,12:55:19,-522800,1919413,50043,ca0dde7390d36318a49cc8b776b6aa0fa12b86f2c3b6ae10983d4f77fd538496,2,51,2,7603,30412,5295842847025639,700938,700938
2021-09-17 12:08:26,2021-09-17,12:08:26,-577999,2442213,58518,e769747ecb28ef6acb81d8d3da3a235f4989c9d27861ecd4fb85b8aa7b4a3bb4,2,60,2,9006,35517,6341335862040336,700934,700934
2021-09-17 12:08:26,2021-09-17,12:08:26,1246667,3020212,19766,493be780bf64664eb3ca9fa7b75fde4d544135d4d8d81e4cf5a8f25bd70100c3,1,1,54,1931,7397,6860953545834069,700934,700934
2021-09-17 10:01:58,2021-09-17,10:01:58,577999,1773545,14335,3bd6f20856d9a8f26637b69842029fd2575868092ce01b4926bdffe2e897423a,1,1,48,1700,6473,2049846107987959,700920,700920
2021-09-17 09:47:46,2021-09-17,09:47:46,522800,1195546,3247,540693c5de03a6703277a1ace33b5c36ba9db1f9151b847abeca8d43fc8375f9,2,1,2,225,900,8777059866800569,700916,700916
2021-09-17 09:06:40,2021-09-17,09:06:40,237690,672746,3384,4ca006c192f5559f3c101a56df5f20f4e832c95c2dcf91d769123c5f003474ea,1,2,2,374,1496,8249113905457026,700914,700914
2021-09-17 06:34:49,2021-09-17,06:34:49,-448398,435056,93774,7d103c1e76e8a5656a7079c72832aec0ebf93944eabd7a0de1e278b121caa777,2,96,2,14236,56944,4210001102384924,700895,700895
2021-09-16 21:25:27,2021-09-16,21:25:27,448398,883454,22339,51bb1be6796924e5036a8afdc8d2672e1ce0dfed8b526abf9ef94840a7c284cb,1,1,73,2520,9753,7160673979599135,700848,700848
2021-09-16 17:07:37,2021-09-16,17:07:37,-449028,435056,557873,d2f1c16f045600deeedefd6d2ac08ff501c060c4c1b38d1616b54aa21a893057,2,633,2,94459,370504,3067711048665430,700825,700825
2021-09-16 11:27:38,2021-09-16,11:27:38,449028,884084,16789,16fd3e05e7d58cf190e0e5fcf06403baa5d74b182eca8333fdfe0d3ee2b86311,1,1,50,1816,6934,611840040616383,700793,700793
2021-09-16 10:01:55,2021-09-16,10:01:55,-262849,435056,209876,4630850055753f6b93390abe0efa0efa6e455c12a516ab8a1f9a5abb4019b212,2,168,2,25044,99348,657796388842323,700785,700785
2021-09-15 20:01:06,2021-09-15,20:01:06,-737774,697905,613305,18ac67ca38b41a2558ce5371635bf7e5676e75dfb69c8cc3387861bf405d9089,2,428,2,63719,252629,4840100250250287,700702,700702
2021-09-15 15:36:00,2021-09-15,15:36:00,-1131209,1435679,26490,bfe288c18b3e1019474db04da1feb4935b51808152df94f4546272363a5cee7d,2,30,2,4573,17560,4430806496235084,700696,700696
2021-09-15 17:31:07,2021-09-15,17:31:07,311086,2566888,51864,7f803c8d1e7b0409181c19a701997d8dfe0c3aa397414158328e6a6de9d4bb82,1,1,90,3082,11998,4599783762013521,700685,700685
2021-09-15 01:27:09,2021-09-15,01:27:09,1131209,2255802,25588,60b813850aaf216a078cf0f0f31b54665650bc3ba8f58feb6ae1b71fb7114c57,1,1,79,2721,10554,3071495243036412,700596,700596
2021-09-15 00:01:00,2021-09-15,00:01:00,-1106856,1124593,59589,ba648296835b603a9724ce83c7e80ddaa2047e08f8cf68df574e05fd0f41d3e4,2,48,2,7250,28208,8051071385575593,700587,700587
2021-09-14 20:45:43,2021-09-14,20:45:43,426688,2231449,1006,8be54a2225c85c17abd69f194af7a30d11e63b62553d40a2bb9897cc503a3fcf,2,1,2,226,574,7291854984418035,700572,700572
2021-09-14 19:35:10,2021-09-14,19:35:10,1106856,1804761,23295,fb8b90ac324a8eb12d4fc0f0d303c9a85e6cfe2b4cfb32e5eb5b8805c3c02376,1,1,69,2393,9242,4156669758058763,700561,700561
2021-09-14 18:01:01,2021-09-14,18:01:01,-732191,697905,82020,4f5bd752e995f91e7103675bc89e7efe53599ed71e01408ab1cbc938f4647cd2,2,66,2,9903,39090,7405814768146745,700557,700557
2021-09-14 14:41:08,2021-09-14,14:41:08,732191,1430096,32785,ea09c1d6bd473ece6952d68de9e6fd2aa35242ca042299dd359264bcf1edc0b2,1,1,79,2741,10637,6289334256241810,700522,700522
2021-09-14 08:46:07,2021-09-14,08:46:07,435056,697905,8303,f0c6cb1e2a532f0c513805e68f0fd70d105abfb44bf106c0dc8b7aa90cea0a46,1,1,38,1415,5333,2464406090100561,700495,700495
2021-09-14 07:50:12,2021-09-14,07:50:12,262849,262849,7444,551de127a10a5b983381a7f6d072cfdffd9837afd2f50c948d9e0e262a72bfd1,1,1,34,1278,4782,7379845898355155,700489,700489
2021-09-12 22:01:03,2021-09-12,22:01:03,-1961284,0,110645,89bcfd4aa2fcdefd9ef45f526cb14a2d9abf08653ae3f18b3d2bc26029b37e77,2,307,2,45714,181290,4204353773377605,700253,700253
2021-09-12 16:16:09,2021-09-12,16:16:09,1961284,1961284,18363,2459eac7b61470bec3a90bcc6a11208ea333db81cc486749017894d8221030ea,1,1,88,3028,11785,8239748801565327,700211,700211
2021-09-10 06:03:34,2021-09-10,06:03:34,-604570,0,139843,7615cf24db7b95ea35585880912f1d09263bf43268b8785a8e51db30840de38f,2,166,2,24748,98167,5062571107687274,699871,699871
2021-09-09 13:29:04,2021-09-09,13:29:04,604570,604570,6243,01be5d96f1924865dd6485c259459cf341d486d4a056ffb0d0a35d29350d55b5,1,3,1,486,1944,6380060749933492,699773,699773
2021-09-07 18:01:19,2021-09-07,18:01:19,-300490,0,352151,f17a10711836fa7f33a5b169f1b364dadcd5bd04d721e8253c3c751edafb532f,2,561,2,83417,331343,1665208133340839,699524,699524
2021-09-07 04:02:47,2021-09-07,04:02:47,-464012,300490,251157,81122969ec803ee40b4dada0710879a5dacd9d58fbd9f23734726e80ff93ca5f,2,625,2,92899,369394,3370357472890318,699430,699430
2021-09-05 07:23:30,2021-09-05,07:23:30,464012,764502,336,ad83de993e4cde18995db77f56814fd005ff57dd5b202d3cc9d348d2d1146e92,2,1,2,225,573,5152047787297050,699118,699118
2021-09-04 06:48:24,2021-09-04,06:48:24,300490,300490,681,44bc8364804d568467755d494601f10ae5e7b0dc9e65b060a08fc75401c19b1c,1,1,2,225,900,1006569075153137,698953,698953
2021-09-02 16:02:17,2021-09-02,16:02:17,-1588599,0,17247,f04240ae7da2b1aab3ac3fb033af2113ab5f3f2417d04240fe9836ef1f0fe2d9,2,11,2,1695,6780,7666078066796243,698717,698717
2021-09-02 12:44:20,2021-09-02,12:44:20,-199122,1588599,270459,807694e53acbe7d675ae1d2075d5e8114bbba83bd5d80a24b5fe0eb7f3ec1d5e,2,208,2,31027,122521,3311443918643679,698693,698693
2021-09-02 11:42:43,2021-09-02,11:42:43,199122,1787721,7258,48f1bd1f6144b9e44404e85cc4f094da63671512a83b2889e209ef9546355562,2,1,1,192,768,3459779377937889,698681,698681
2021-09-02 09:38:27,2021-09-02,09:38:27,1588599,1588599,541,e6378629a52703cd9ec348cfbfb187d84d02965812bd9e198040900050499d7a,2,2,1,343,721,4314110669885960,698673,698673
2021-09-01 11:20:21,2021-09-01,11:20:21,-682992,0,56514,b3397b0c14c6eca764ad73d51f89b49b66f9f34e0512992f5033e313c7ad48a2,2,75,2,11233,44380,5709857179204710,698598,698598
2021-09-01 09:46:05,2021-09-01,09:46:05,682992,682992,2034,526809923b516f04f281de8540cb7cc147b47da9ef7125214cd0fbb7e89d273c,1,1,2,226,904,2116507221294970,698533,698533
2021-09-01 00:01:44,2021-09-01,00:01:44,-681515,0,31302,dc923e4add94f3e38dceaa212c5cfb084fedaf1481d1bed670bdd422159b66ac,2,39,2,5892,23127,6065814031850135,698476,698476
2021-08-31 21:03:58,2021-08-31,21:03:58,681515,681515,671,fcd1e28e3d221cb27d97d2a1df92165a42ce4ffe0d96ebf30bd6a252fc09f570,2,1,2,226,574,3974327578547290,698460,698460
2021-08-26 10:07:08,2021-08-26,10:07:08,-260405,0,123149,deb5f53d150a32805801c3219a175b1329ec69ca329592c8b370d0aa9ca07e78,2,671,2,99854,395162,4239528186698254,697666,697666
2021-08-25 22:26:47,2021-08-25,22:26:47,102212,260405,336,0c2de0642a15681dad066e68375c85362f7bb01741407dc2079233ce1fa1a254,2,1,2,226,574,2977838868842098,697595,697595
2021-08-19 14:01:17,2021-08-19,14:01:17,-1211400,158193,36458,04d616004deea9cda0a03551c5c636a611a77bd6ad11f9e9337128d0a77f0a4b,2,110,2,16435,65083,2640270830732558,696533,696533
2021-08-18 09:52:37,2021-08-18,09:52:37,1211400,1369593,2043,14cb97b8ff09f14dad3f06596dc7bb113549e2aaf401123e23b3ed0a5cceacb7,1,1,2,225,900,6462490380688822,696367,696367
2021-08-17 15:03:29,2021-08-17,15:03:29,73006,158193,989,a828e0618f01f747b21c45c415d83741d35f008f664ed982bb0bb39adf068d4e,2,3,1,492,1314,2763763605526113,696244,696244
2021-08-14 16:06:45,2021-08-14,16:06:45,85187,85187,336,b9a93966386280891b073d97cf2e8519baaa1550eff8432c50097e439e6adcf7,2,1,2,226,574,8720833715924929,695752,695752
2021-08-05 09:12:22,2021-08-05,09:12:22,-322506,0,195980,a1225781e5742348eb017920af227b0dfecf56252c78da7f91c165472fa10732,2,655,2,97374,386886,1760267212483768,694291,694291
2021-08-04 07:20:52,2021-08-04,07:20:52,322506,322506,12118,9375315a9f3244b162ad9a5b14792e8b65889780e25d02dbd262d9749fe47e1c,1,19,34,7375,15106,1002602467597100,694135,694135
2021-07-30 09:05:18,2021-07-30,09:05:18,-808370,0,171889,fa12929b760fcf711aba3476d1f53755f2d419f0b7161d8e334bf21f275ae736,2,575,2,85542,339156,1931752891481673,693371,693371
2021-07-26 10:38:50,2021-07-26,10:38:50,808370,808370,336,e317f836c838027549e0c7dc2ab9b3fa1e4d3bfaf122d6f3b3630d2a89794c97,2,1,2,226,574,5323350794912172,692737,692737
2021-07-23 08:06:12,2021-07-23,08:06:12,-185496,0,159519,63ecdb379b47730e94c6708b06767e45a3b6e4eab0591b99c6633696e77a5244,2,532,2,78533,314132,2403873280149196,692263,692263
2021-07-22 09:41:49,2021-07-22,09:41:49,185496,185496,4332,91ed08d09c6f1b686d6eb49854195e6948b8c39819a384f2b2ddeb6bbc6aa29d,1,4,1,635,2540,5546268831874427,692130,692130
2021-07-01 16:01:23,2021-07-01,16:01:23,-111515,0,3273003,318c0ab9c7d3ce98fe6f117160242169a7e19f0e1a4c08c4c5d6dcab5185627a,2,280,2,41720,165395,4306033987386266,689318,689318
2021-06-26 17:52:41,2021-06-26,17:52:41,111515,111515,698,c50bfa743f4dd9fd977e597559534cd8a76c2c8ddfc884c8f1dfe1128255b348,1,1,1,191,764,2557922269879355,688913,688913
2021-06-08 01:01:42,2021-06-08,01:01:42,-1118800,0,636402,2080e8c6e76d77fabe8e0e20fd8134bb926511e4d8d6681c1f987f7e9a78c313,2,185,2,27370,109480,695368414121971,686723,686723
2021-06-07 18:10:43,2021-06-07,18:10:43,1118800,1118800,12408,c7b93c9d63818c989cbd9b8575c623799f8d8200a8ef19c04ce93a4196571d49,1,2,2,372,1488,2572491915011933,686688,686688
2021-06-05 16:07:10,2021-06-05,16:07:10,-638817,0,874969,bfe64614b162ee19daf498c3e4ace8adb8b9f6a0f6bab3bdc4f7c0a9d3403c31,2,181,2,26992,106783,1732315373189150,686390,686390
2021-06-05 12:10:11,2021-06-05,12:10:11,638817,638817,48359,55ae4347fb165c62962b4983c13aba740a74631b41b796995a3e15074d418b8d,1,7,39,3612,9138,4980135537205927,686369,686369
2021-06-03 04:09:01,2021-06-03,04:09:01,-949574,0,2463655,c01faa12eaad0014fc6dc725d4f44846a483eefb84deab7757d33f5d359c05d1,2,399,2,59464,234739,7354304825108474,686052,686052
2021-06-02 18:32:07,2021-06-02,18:32:07,368620,949574,4086,b77b801926d28c3052874ea7cd5bdf7f1fdbcf140d06898ff9c1aeb20045134d,1,1,2,226,904,2711845036512728,685998,685998
2021-06-02 17:46:37,2021-06-02,17:46:37,580954,580954,10442,30dca71d42f9dee89be7b1ed4a3069af63dec0e7420ce915bb1186a44dad1605,1,1,2,226,904,179038558916802,685986,685986
2021-05-11 18:01:39,2021-05-11,18:01:39,-92948,0,3841993,79d174efe9a73369f32e00b9c6e7156cb31cae7dc424daf3e423bc7f63255d6d,2,511,2,76091,301229,3847898453243780,683142,683142
2021-05-11 10:41:21,2021-05-11,10:41:21,92948,92948,908,d901bba7452681524e4e9a602f88e0c1ff9efcf3a8c6b33482cd887b6e254419,1,1,2,226,904,888975246979353,683100,683100
2021-05-10 18:01:13,2021-05-10,18:01:13,-166138,0,6128314,3a2accc9223713f0bf8e2fec31ea0cf7e10699165d36bb3c453771709b7ccbac,2,577,2,85806,340851,6079679004806694,682981,682981
2021-05-10 10:00:54,2021-05-10,10:00:54,-243484,166138,3699521,69f5ad244cbe9e1757516fb42138a49ca7e55e5a2620c83df68e33929bd1231d,2,300,2,44752,176509,1025269686224497,682916,682916
2021-05-10 10:00:47,2021-05-10,10:00:47,-3048975,409622,3077000,8fb4a687136f12f4969276792cceec7180228bd608256daab43aeab3ad1bcc5a,2,249,2,37124,146780,3194645894298951,682916,682916
2021-05-10 07:27:31,2021-05-10,07:27:31,2105885,3458597,19210,241fd05e10b51463ac8ee577374bbe420de4e507366ccf8e5b58302b2bb55fc3,1,1,1,191,764,6874106522068491,682901,682901
2021-05-09 09:14:30,2021-05-09,09:14:30,501870,1352712,1130,1616e189266b9a3c364acad0b327ed17c29bc3aa1964bf896863ee6b4f33f5e8,1,1,1,191,764,8196474415185356,682720,682720
2021-05-08 20:38:32,2021-05-08,20:38:32,243484,850842,9350,8821f2c726a3a8abc08c5dbe1685eb27b26eaef31cd72e8fbdcdbef90a7778b2,1,2,2,373,1492,6279374816884697,682621,682621
2021-05-08 13:14:18,2021-05-08,13:14:18,441220,607358,1135,d64ed8fe33c981dce8c638c034560111bc49b6bb434683d5b4daeb1ec9219c3e,1,1,2,226,904,2202889684770171,682576,682576
2021-05-08 12:34:05,2021-05-08,12:34:05,166138,166138,255461,7aa53e62f9bf1dac712bbef963d95bbbabf4595b24838bf91bd811c67961d754,1,1,88,3013,11722,2985088962314811,682568,682568
2021-05-07 04:03:22,2021-05-07,04:03:22,-88805,0,7613333,42b2e27362550675775fa9cf685a2ada2c7a260a59c5aa555a9f300232bf6cd6,2,615,2,90769,363076,7544401681204755,682334,682334
2021-05-06 22:00:44,2021-05-06,22:00:44,-615243,88805,4372496,4fb510f9bfdd4d390ccbe6eb02e26089b7fa6b6b3661733eaa5967e034293ded,2,340,2,50677,200089,8347102083812587,682284,682284
2021-05-05 11:56:41,2021-05-05,11:56:41,88805,704048,1808,ba6f0feef735aa1e59d5b0c0dfe61c85fbdc7b8eed65744fc2d3b81d4d636df3,1,1,2,226,904,8564836575459098,682112,682112
2021-05-05 04:36:17,2021-05-05,04:36:17,615243,615243,9660,bcee10bfd05ce4c3b41c57a6c28713858633e53f74c727f0f05d7d3e33029b10,1,6,1,928,3712,584254172417963,682001,682001
2021-04-24 12:00:15,2021-04-24,12:00:15,-179385,0,10000000,8a02db3cafd429764406fc90e7fe2e3b106406478657ae1b1a2b6c32be2ab1fb,2,520,1,76760,307040,8855627036511621,680410,680410
2021-04-24 09:05:46,2021-04-24,09:05:46,179385,179385,10615,0d17df6ef0bf81777445671292d6d04779827c0998cbbd44a4e84921411d59f6,1,1,1,192,768,8667603306555709,680397,680397
