fips,county_name,state_abbr,left,arrived,net
04013,Maricopa County,AZ,530616,671812,141196
32003,Clark County,NV,291987,392234,100247
48453,Travis County,TX,425184,496981,71797
06065,Riverside County,CA,376481,437530,61049
12071,Lee County,FL,113530,168436,54906
48121,Denton County,TX,218651,272631,53980
48491,Williamson County,TX,129075,179698,50623
48085,Collin County,TX,249080,298436,49356
48157,Fort Bend County,TX,142615,187223,44608
12099,Palm Beach County,FL,269402,312479,43077
12101,Pasco County,FL,102661,143539,40878
48339,Montgomery County,TX,106039,145130,39091
12105,Polk County,FL,104604,142907,38303
12103,Pinellas County,FL,186645,224723,38078
45051,Horry County,SC,37093,68124,31031
37183,Wake County,NC,211179,241704,30525
04021,Pinal County,AZ,74212,103581,29369
12115,Sarasota County,FL,79199,108379,29180
12009,Brevard County,FL,73452,102448,28996
48029,Bexar County,TX,275253,304191,28938
12081,Manatee County,FL,62916,91592,28676
12127,Volusia County,FL,81470,109199,27729
12069,Lake County,FL,65859,93168,27309
48439,Tarrant County,TX,385954,413251,27297
53053,Pierce County,WA,182386,208407,26021
53061,Snohomish County,WA,148747,172733,23986
08031,Denver County,CO,307458,331412,23954
16001,Ada County,ID,67294,90801,23507
53011,Clark County,WA,73313,95464,22151
12111,St. Lucie County,FL,51373,73412,22039
37119,Mecklenburg County,NC,246874,268708,21834
12109,St. Johns County,FL,41369,63055,21686
10005,Sussex County,DE,23063,44651,21588
08123,Weld County,CO,51869,72779,20910
08035,Douglas County,CO,84523,104874,20351
51107,Loudoun County,VA,79581,99442,19861
06067,Sacramento County,CA,235888,253556,17668
12021,Collier County,FL,63206,80775,17569
06061,Placer County,CA,81498,97990,16492
41017,Deschutes County,OR,28891,45283,16392
13117,Forsyth County,GA,36514,52704,16190
12097,Osceola County,FL,98982,114813,15831
04025,Yavapai County,AZ,31602,47414,15812
12083,Marion County,FL,46565,62284,15719
18057,Hamilton County,IN,59663,75353,15690
08059,Jefferson County,CO,175035,190427,15392
32031,Washoe County,NV,64698,79732,15034
48091,Comal County,TX,30873,45781,14908
08001,Adams County,CO,142329,157236,14907
48209,Hays County,TX,50785,65497,14712
34029,Ocean County,NJ,76042,90660,14618
12031,Duval County,FL,189521,203987,14466
08041,El Paso County,CO,147427,160942,13515
45091,York County,SC,33329,46705,13376
12057,Hillsborough County,FL,326763,339807,13044
41005,Clackamas County,OR,98611,111381,12770
13057,Cherokee County,GA,43905,56614,12709
37019,Brunswick County,NC,14266,26823,12557
06077,San Joaquin County,CA,96399,108947,12548
16027,Canyon County,ID,32194,44660,12466
12015,Charlotte County,FL,26953,38878,11925
12119,Sumter County,FL,15076,26950,11874
53063,Spokane County,WA,61849,73698,11849
48257,Kaufman County,TX,25739,37445,11706
48167,Galveston County,TX,57061,68660,11599
48039,Brazoria County,TX,59838,71399,11561
29183,St. Charles County,MO,57762,68921,11159
05007,Benton County,AR,35290,46333,11043
45045,Greenville County,SC,73405,84394,10989
37101,Johnston County,NC,26941,37905,10964
53033,King County,WA,473711,484645,10934
04019,Pima County,AZ,118805,129399,10594
45019,Charleston County,SC,88270,98534,10264
48139,Ellis County,TX,28570,38801,10231
53067,Thurston County,WA,55935,66162,10227
39041,Delaware County,OH,37191,47083,9892
49053,Washington County,UT,20859,30645,9786
01003,Baldwin County,AL,19222,28956,9734
12053,Hernando County,FL,26864,36582,9718
47187,Williamson County,TN,42862,52276,9414
47149,Rutherford County,TN,56197,65583,9386
48367,Parker County,TX,24649,34004,9355
04015,Mohave County,AZ,24438,33748,9310
16055,Kootenai County,ID,19613,28871,9258
13151,Henry County,GA,51925,60794,8869
06013,Contra Costa County,CA,215872,224641,8769
12061,Indian River County,FL,18192,26911,8719
37025,Cabarrus County,NC,36044,44746,8702
24021,Frederick County,MD,39586,47913,8327
48187,Guadalupe County,TX,36453,44592,8139
08005,Arapahoe County,CO,225664,233683,8019
41051,Multnomah County,OR,218386,226362,7976
18063,Hendricks County,IN,30203,38178,7975
40017,Canadian County,OK,25806,33779,7973
13223,Paulding County,GA,30226,38166,7940
06017,El Dorado County,CA,34633,42572,7939
45083,Spartanburg County,SC,31790,39702,7912
48251,Johnson County,TX,30256,38123,7867
06095,Solano County,CA,78832,86531,7699
22103,St. Tammany Parish,LA,30473,37915,7442
47189,Wilson County,TN,22339,29744,7405
51041,Chesterfield County,VA,64411,71815,7404
28033,DeSoto County,MS,26977,34319,7342
23031,York County,ME,31262,38575,7313
47165,Sumner County,TN,29528,36771,7243
54003,Berkeley County,WV,12781,19904,7123
17093,Kendall County,IL,26953,33900,6947
36091,Saratoga County,NY,40950,47891,6941
19049,Dallas County,IA,20161,26997,6836
45015,Berkeley County,SC,51466,58273,6807
25023,Plymouth County,MA,80877,87548,6671
33015,Rockingham County,NH,66298,72961,6663
12085,Martin County,FL,28622,35219,6597
13073,Columbia County,GA,24700,31253,6553
45013,Beaufort County,SC,25165,31674,6509
41067,Washington County,OR,138699,145170,6471
39165,Warren County,OH,45079,51482,6403
41029,Jackson County,OR,25155,31449,6294
29047,Clay County,MO,50998,57239,6241
41047,Marion County,OR,50218,56354,6136
26093,Livingston County,MI,30986,37059,6073
48397,Rockwall County,TX,21486,27462,5976
37179,Union County,NC,30121,36070,5949
37021,Buncombe County,NC,41919,47820,5901
35043,Sandoval County,NM,25756,31653,5897
24003,Anne Arundel County,MD,128929,134813,5884
47125,Montgomery County,TN,42766,48644,5878
45063,Lexington County,SC,46685,52483,5798
25001,Barnstable County,MA,32873,38666,5793
24017,Charles County,MD,28874,34448,5574
12113,Santa Rosa County,FL,29556,35124,5568
45057,Lancaster County,SC,10447,15992,5545
12017,Citrus County,FL,16656,22194,5538
42041,Cumberland County,PA,37895,43259,5364
51179,Stafford County,VA,33050,38400,5350
48021,Bastrop County,TX,13883,19176,5293
46083,Lincoln County,SD,13943,19212,5269
06071,San Bernardino County,CA,366401,371649,5248
37071,Gaston County,NC,28914,34078,5164
20091,Johnson County,KS,108609,113744,5135
12035,Flagler County,FL,16524,21655,5131
08069,Larimer County,CO,67896,73007,5111
13013,Barrow County,GA,14691,19796,5105
10001,Kent County,DE,19855,24950,5095
25005,Bristol County,MA,69388,74471,5083
27163,Washington County,MN,58239,63311,5072
13157,Jackson County,GA,12006,16991,4985
55133,Waukesha County,WI,70876,75803,4927
13135,Gwinnett County,GA,217462,222384,4922
13139,Hall County,GA,27852,32744,4892
12019,Clay County,FL,46055,50938,4883
53035,Kitsap County,WA,49040,53914,4874
48181,Grayson County,TX,16206,21037,4831
42095,Northampton County,PA,50437,55142,4705
19153,Polk County,IA,68240,72889,4649
06079,San Luis Obispo County,CA,40787,45426,4639
48291,Liberty County,TX,13785,18408,4623
02170,Matanuska-Susitna Borough,AK,10854,15465,4611
39093,Lorain County,OH,34457,39055,4598
18081,Johnson County,IN,32740,37330,4590
42133,York County,PA,50668,55255,4587
53057,Skagit County,WA,17177,21727,4550
37089,Henderson County,NC,13437,17948,4511
12131,Walton County,FL,9560,14054,4494
51177,Spotsylvania County,VA,25594,30016,4422
12117,Seminole County,FL,136098,140510,4412
18127,Porter County,IN,24543,28954,4411
47119,Maury County,TN,14627,19037,4410
53005,Benton County,WA,31255,35662,4407
37063,Durham County,NC,83874,88271,4397
31153,Sarpy County,NE,40878,45214,4336
32019,Lyon County,NV,10593,14898,4305
05125,Saline County,AR,17363,21649,4286
27139,Scott County,MN,29512,33730,4218
01117,Shelby County,AL,38936,43145,4209
42019,Butler County,PA,21326,25507,4181
22005,Ascension Parish,LA,16177,20335,4158
06057,Nevada County,CA,17361,21400,4039
12089,Nassau County,FL,10033,13973,3940
27019,Carver County,MN,18747,22681,3934
27171,Wright County,MN,24332,28263,3931
22063,Livingston Parish,LA,18660,22586,3926
51550,Chesapeake city,VA,59479,63390,3911
41039,Lane County,OR,48123,52029,3906
49045,Tooele County,UT,9675,13535,3860
51069,Frederick County,VA,14050,17902,3852
51800,Suffolk city,VA,17361,21200,3839
37085,Harnett County,NC,26976,30800,3824
01089,Madison County,AL,43697,47519,3822
29099,Jefferson County,MO,33397,37174,3777
42091,Montgomery County,PA,157029,160771,3742
13297,Walton County,GA,15758,19466,3708
48497,Wise County,TX,10129,13824,3695
23005,Cumberland County,ME,51782,55476,3694
39103,Medina County,OH,27876,31538,3662
41043,Linn County,OR,20176,23810,3634
39089,Licking County,OH,25129,28760,3631
37001,Alamance County,NC,19728,23355,3627
18059,Hancock County,IN,14504,18130,3626
13077,Coweta County,GA,21925,25524,3599
37069,Franklin County,NC,9569,13166,3597
39045,Fairfield County,OH,27114,30699,3585
13217,Newton County,GA,21656,25214,3558
53029,Island County,WA,17681,21230,3549
48221,Hood County,TX,8762,12281,3519
33013,Merrimack County,NH,28127,31623,3496
06069,San Benito County,CA,8471,11960,3489
01083,Limestone County,AL,11312,14788,3476
15001,Hawaii County,HI,16119,19532,3413
47065,Hamilton County,TN,43623,47023,3400
48473,Waller County,TX,9741,13128,3387
28121,Rankin County,MS,21278,24653,3375
27003,Anoka County,MN,79607,82962,3355
53015,Cowlitz County,WA,13777,17109,3332
48231,Hunt County,TX,16259,19568,3309
49057,Weber County,UT,39589,42859,3270
48259,Kendall County,TX,7694,10952,3258
44003,Kent County,RI,32346,35596,3250
28089,Madison County,MS,17539,20764,3225
01115,St. Clair County,AL,12440,15648,3208
33017,Strafford County,NH,22749,25956,3207
18011,Boone County,IN,10833,14002,3169
42103,Pike County,PA,7978,11144,3166
53073,Whatcom County,WA,27748,30892,3144
30029,Flathead County,MT,8392,11532,3140
34019,Hunterdon County,NJ,19175,22287,3112
32023,Nye County,NV,4987,8089,3102
37097,Iredell County,NC,23032,26126,3094
51085,Hanover County,VA,16686,19738,3052
53045,Mason County,WA,10214,13260,3046
06099,Stanislaus County,CA,63502,66544,3042
26139,Ottawa County,MI,45429,48451,3022
37125,Moore County,NC,10062,13033,2971
34041,Warren County,NJ,17307,20276,2969
13015,Bartow County,GA,14815,17704,2889
39025,Clermont County,OH,35093,37963,2870
42089,Monroe County,PA,25558,28392,2834
20029,Cloud County,KS,189,3016,2827
37037,Chatham County,NC,11378,14190,2812
53009,Clallam County,WA,6678,9473,2795
24025,Harford County,MD,37442,40214,2772
17111,McHenry County,IL,51256,54027,2771
32005,Douglas County,NV,9251,12020,2769
47093,Knox County,TN,66550,69304,2754
41033,Josephine County,OR,9374,12127,2753
18019,Clark County,IN,20382,23128,2746
34015,Gloucester County,NJ,45109,47848,2739
55131,Washington County,WI,21085,23810,2725
13103,Effingham County,GA,7809,10524,2715
49011,Davis County,UT,64920,67590,2670
04017,Navajo County,AZ,15891,18555,2664
45007,Anderson County,SC,22109,24756,2647
53041,Lewis County,WA,10542,13188,2646
06005,Amador County,CA,3889,6534,2645
29113,Lincoln County,MO,8353,10993,2640
37141,Pender County,NC,9080,11718,2638
37109,Lincoln County,NC,11975,14583,2608
21029,Bullitt County,KY,15052,17581,2529
55109,St. Croix County,WI,13964,16488,2524
36111,Ulster County,NY,22628,25138,2510
48213,Henderson County,TX,12880,15378,2498
51061,Fauquier County,VA,12038,14534,2496
09005,Litchfield County,CT,25820,28307,2487
48381,Randall County,TX,29253,31736,2483
39085,Lake County,OH,29346,31818,2472
06009,Calaveras County,CA,6325,8792,2467
40145,Wagoner County,OK,17320,19773,2453
42125,Washington County,PA,22439,24862,2423
08039,Elbert County,CO,4960,7346,2386
29037,Cass County,MO,17650,20027,2377
37057,Davidson County,NC,22232,24608,2376
22105,Tangipahoa Parish,LA,15582,17955,2373
42029,Chester County,PA,83756,86119,2363
08077,Mesa County,CO,15427,17786,2359
55059,Kenosha County,WI,23292,25646,2354
27141,Sherburne County,MN,22522,24868,2346
47047,Fayette County,TN,6924,9264,2340
17089,Kane County,IL,97660,99998,2338
26005,Allegan County,MI,21389,23720,2331
06033,Lake County,CA,6156,8479,2323
21209,Scott County,KY,7729,10040,2311
33001,Belknap County,NH,11645,13946,2301
46103,Pennington County,SD,15318,17554,2236
06115,Yuba County,CA,14491,16705,2214
39159,Union County,OH,8983,11191,2208
48053,Burnet County,TX,7720,9897,2177
34037,Sussex County,NJ,21430,23605,2175
26055,Grand Traverse County,MI,13361,15529,2168
37129,New Hanover County,NC,39179,41344,2165
24013,Carroll County,MD,24026,26187,2161
13097,Douglas County,GA,36715,38872,2157
33003,Carroll County,NH,7106,9261,2155
29165,Platte County,MO,27886,30003,2117
06109,Tuolumne County,CA,5368,7468,2100
48467,Van Zandt County,TX,8004,10104,2100
51109,Louisa County,VA,4523,6602,2079
41071,Yamhill County,OR,16261,18333,2072
09007,Middlesex County,CT,30287,32349,2062
29043,Christian County,MO,16557,18590,2033
41009,Columbia County,OR,6856,8872,2016
06047,Merced County,CA,29990,31995,2005
51095,James City County,VA,12863,14863,2000
36105,Sullivan County,NY,8918,10902,1984
48071,Chambers County,TX,8823,10802,1979
16019,Bonneville County,ID,14305,16284,1979
55105,Rock County,WI,16792,18721,1929
27059,Isanti County,MN,8364,10262,1898
51047,Culpeper County,VA,6600,8489,1889
41013,Crook County,OR,2500,4374,1874
30111,Yellowstone County,MT,15707,17581,1874
42127,Wayne County,PA,5796,7669,1873
24035,Queen Anne's County,MD,7202,9074,1872
15009,Maui County,HI,14477,16331,1854
48499,Wood County,TX,6182,8032,1850
47163,Sullivan County,TN,18290,20132,1842
48373,Polk County,TX,7357,9197,1840
56021,Laramie County,WY,11776,13612,1836
27037,Dakota County,MN,97299,99122,1823
08014,Broomfield County,CO,32430,34241,1811
08101,Pueblo County,CO,14255,16057,1802
36069,Ontario County,NY,15731,17513,1782
06039,Madera County,CA,17759,19536,1777
37053,Currituck County,NC,3425,5198,1773
13085,Dawson County,GA,4808,6560,1752
13227,Pickens County,GA,4457,6203,1746
22055,Lafayette Parish,LA,37169,38906,1737
12055,Highlands County,FL,10584,12316,1732
51019,Bedford County,VA,11339,13071,1732
42075,Lebanon County,PA,14669,16401,1732
37093,Hoke County,NC,11238,12969,1731
41053,Polk County,OR,18451,20176,1725
36079,Putnam County,NY,17294,19012,1718
08093,Park County,CO,2923,4639,1716
22087,St. Bernard Parish,LA,6285,7999,1714
38017,Cass County,ND,29211,30916,1705
48055,Caldwell County,TX,8022,9721,1699
06089,Shasta County,CA,21129,22811,1682
24043,Washington County,MD,19207,20875,1668
17063,Grundy County,IL,9454,11121,1667
48329,Midland County,TX,33008,34672,1664
24015,Cecil County,MD,13511,15175,1664
48493,Wilson County,TX,7029,8691,1662
53031,Jefferson County,WA,3961,5607,1646
55089,Ozaukee County,WI,14140,15784,1644
47147,Robertson County,TN,12453,14095,1642
04007,Gila County,AZ,6911,8550,1639
47009,Blount County,TN,15144,16774,1630
12023,Columbia County,FL,8217,9841,1624
06097,Sonoma County,CA,66040,67664,1624
18173,Warrick County,IN,9405,11021,1616
53027,Grays Harbor County,WA,8702,10317,1615
55127,Walworth County,WI,17022,18636,1614
42001,Adams County,PA,13630,15242,1612
39109,Miami County,OH,14425,16037,1612
42025,Carbon County,PA,8565,10172,1607
09013,Tolland County,CT,26667,28267,1600
32510,Carson City,NV,11693,13263,1570
49051,Wasatch County,UT,4886,6454,1568
51127,New Kent County,VA,3058,4620,1562
37159,Rowan County,NC,17468,19018,1550
54037,Jefferson County,WV,7784,9328,1544
24009,Calvert County,MD,11827,13365,1538
41019,Douglas County,OR,10121,11649,1528
36027,Dutchess County,NY,39007,40535,1528
42017,Bucks County,PA,100435,101954,1519
06103,Tehama County,CA,6813,8329,1516
55101,Racine County,WI,25540,27048,1508
29219,Warren County,MO,6334,7836,1502
42055,Franklin County,PA,13183,14671,1488
51137,Orange County,VA,6300,7786,1486
27035,Crow Wing County,MN,8623,10093,1470
51187,Warren County,VA,5916,7376,1460
24027,Howard County,MD,79221,80679,1458
35049,Santa Fe County,NM,21277,22734,1457
47021,Cheatham County,TN,8058,9512,1454
26099,Macomb County,MI,134722,136176,1454
37077,Granville County,NC,8068,9520,1452
05031,Craighead County,AR,13078,14529,1451
39129,Pickaway County,OH,9339,10790,1451
26015,Barry County,MI,9679,11128,1449
24037,St. Mary's County,MD,13048,14496,1448
48325,Medina County,TX,6737,8177,1440
13029,Bryan County,GA,6715,8153,1438
48027,Bell County,TX,88235,89642,1407
27025,Chisago County,MN,11218,12619,1401
13153,Houston County,GA,21829,23228,1399
44009,Washington County,RI,19760,21158,1398
13255,Spalding County,GA,11311,12705,1394
48407,San Jacinto County,TX,4913,6306,1393
53021,Franklin County,WA,17822,19193,1371
50011,Franklin County,VT,5594,6963,1369
37087,Haywood County,NC,4399,5766,1367
36039,Greene County,NY,5629,6993,1364
54079,Putnam County,WV,7228,8590,1362
19181,Warren County,IA,8405,9760,1355
48299,Llano County,TX,2769,4117,1348
08043,Fremont County,CO,3837,5184,1347
37031,Carteret County,NC,7728,9074,1346
55087,Outagamie County,WI,35666,36998,1332
51145,Powhatan County,VA,3943,5271,1328
53007,Chelan County,WA,13927,15255,1328
26121,Muskegon County,MI,16384,17702,1318
26115,Monroe County,MI,19842,21141,1299
51075,Goochland County,VA,3652,4946,1294
40087,McClain County,OK,8231,9522,1291
51033,Caroline County,VA,5514,6802,1288
18091,LaPorte County,IN,11051,12334,1283
21211,Shelby County,KY,7062,8342,1280
13177,Lee County,GA,4476,5729,1253
51093,Isle of Wight County,VA,6035,7281,1246
55055,Jefferson County,WI,14789,16033,1244
40131,Rogers County,OK,16843,18081,1238
45003,Aiken County,SC,17519,18752,1233
49021,Iron County,UT,7065,8284,1219
36021,Columbia County,NY,7354,8572,1218
01051,Elmore County,AL,13016,14224,1208
51015,Augusta County,VA,10366,11561,1195
23011,Kennebec County,ME,15695,16888,1193
47043,Dickson County,TN,6909,8102,1193
18109,Morgan County,IN,12930,14123,1193
36025,Delaware County,NY,4497,5681,1184
40083,Logan County,OK,7979,9151,1172
21185,Oldham County,KY,9693,10861,1168
09015,Windham County,CT,15694,16844,1150
48185,Grimes County,TX,4254,5397,1143
26087,Lapeer County,MI,13323,14455,1132
17199,Williamson County,IL,6873,7998,1125
48147,Fannin County,TX,4699,5819,1120
37067,Forsyth County,NC,54677,55795,1118
29071,Franklin County,MO,12733,13847,1114
24047,Worcester County,MD,8368,9482,1114
49003,Box Elder County,UT,6998,8110,1112
37167,Stanly County,NC,5271,6381,1110
13121,Fulton County,GA,400346,401449,1103
13219,Oconee County,GA,5747,6845,1098
13145,Harris County,GA,5178,6275,1097
34009,Cape May County,NJ,13218,14313,1095
48423,Smith County,TX,34205,35300,1095
41031,Jefferson County,OR,2535,3628,1093
47117,Marshall County,TN,4426,5519,1093
41041,Lincoln County,OR,7434,8518,1084
51165,Rockingham County,VA,9721,10805,1084
06045,Mendocino County,CA,7778,8851,1073
12129,Wakulla County,FL,3503,4561,1058
53037,Kittitas County,WA,7574,8629,1055
01043,Cullman County,AL,6879,7934,1055
26143,Roscommon County,MI,2353,3396,1043
33011,Hillsborough County,NH,76969,77999,1030
40027,Cleveland County,OK,59687,60712,1025
53049,Pacific County,WA,2334,3350,1016
53017,Douglas County,WA,9234,10238,1004
08015,Chaffee County,CO,1388,2390,1002
55095,Polk County,WI,5962,6959,997
05051,Garland County,AR,9802,10797,995
13183,Long County,GA,2820,3796,976
36093,Schenectady County,NY,25116,26079,963
39117,Morrow County,OH,5827,6786,959
53065,Stevens County,WA,5531,6482,951
51099,King George County,VA,3866,4813,947
45055,Kershaw County,SC,7502,8443,941
12011,Broward County,FL,440338,441275,937
23017,Oxford County,ME,6797,7732,935
26037,Clinton County,MI,15756,16685,929
42107,Schuylkill County,PA,12312,13241,929
47011,Bradley County,TN,10790,11718,928
55001,Adams County,WI,2615,3543,928
13047,Catoosa County,GA,11990,12910,920
16017,Bonner County,ID,4766,5683,917
33005,Cheshire County,NH,8722,9635,913
05055,Greene County,AR,4520,5428,908
16083,Twin Falls County,ID,10573,11473,900
19163,Scott County,IA,19643,20539,896
38015,Burleigh County,ND,12725,13620,895
48019,Bandera County,TX,2751,3644,893
51171,Shenandoah County,VA,4885,5775,890
33019,Sullivan County,NH,5544,6426,882
13247,Rockdale County,GA,23748,24626,878
08029,Delta County,CO,2628,3498,870
40013,Bryan County,OK,4602,5465,863
28045,Hancock County,MS,5786,6642,856
28073,Lamar County,MS,12456,13305,849
47031,Coffee County,TN,7855,8704,849
55083,Oconto County,WI,5181,6028,847
41007,Clatsop County,OR,5065,5898,833
27115,Pine County,MN,3992,4824,832
13291,Union County,GA,1198,2028,830
01113,Russell County,AL,14669,15498,829
13237,Putnam County,GA,2149,2974,825
18095,Madison County,IN,15031,15850,819
26123,Newaygo County,MI,6980,7799,819
30031,Gallatin County,MT,14831,15648,817
51149,Prince George County,VA,8083,8896,813
26147,St. Clair County,MI,18095,18906,811
13123,Gilmer County,GA,2308,3115,807
53039,Klickitat County,WA,2525,3331,806
12107,Putnam County,FL,9009,9814,805
48013,Atascosa County,TX,7445,8248,803
26129,Ogemaw County,MI,1914,2716,802
27021,Cass County,MN,4595,5397,802
23001,Androscoggin County,ME,14299,15094,795
47167,Tipton County,TN,7591,8382,791
18043,Floyd County,IN,16662,17452,790
13211,Morgan County,GA,2032,2821,789
13207,Monroe County,GA,3516,4304,788
21113,Jessamine County,KY,8541,9329,788
13137,Habersham County,GA,4681,5466,785
21151,Madison County,KY,10475,11260,785
37105,Lee County,NC,9531,10311,780
55125,Vilas County,WI,2021,2800,779
08085,Montrose County,CO,4142,4916,774
55013,Burnett County,WI,1346,2119,773
41057,Tillamook County,OR,2832,3595,763
21117,Kenton County,KY,38208,38968,760
47003,Bedford County,TN,6005,6763,758
27001,Aitkin County,MN,1493,2243,750
37059,Davie County,NC,5326,6075,749
55017,Chippewa County,WI,9364,10111,747
08045,Garfield County,CO,7864,8609,745
20103,Leavenworth County,KS,13923,14668,745
13111,Fannin County,GA,1600,2345,745
39097,Madison County,OH,7660,8404,744
47111,Macon County,TN,2190,2931,741
48217,Hill County,TX,5081,5822,741
48459,Upshur County,TX,7126,7865,739
48097,Cooke County,TX,6112,6844,732
38059,Morton County,ND,6520,7249,729
48135,Ector County,TX,25000,25724,724
13143,Haralson County,GA,4366,5089,723
51073,Gloucester County,VA,4152,4874,722
55111,Sauk County,WI,9566,10282,716
46127,Union County,SD,2524,3239,715
55085,Oneida County,WI,4209,4919,710
13311,White County,GA,3276,3985,709
12075,Levy County,FL,6281,6989,708
01009,Blount County,AL,7527,8225,698
26117,Montcalm County,MI,10224,10918,694
48265,Kerr County,TX,6107,6800,693
51101,King William County,VA,2499,3188,689
26031,Cheboygan County,MI,2219,2899,680
49037,San Juan County,UT,1072,1751,679
40081,Lincoln County,OK,5290,5969,679
30081,Ravalli County,MT,3801,4477,676
12121,Suwannee County,FL,4564,5239,675
26035,Clare County,MI,3404,4077,673
47105,Loudon County,TN,8284,8956,672
13129,Gordon County,GA,6159,6831,672
20121,Miami County,KS,5261,5932,671
29015,Benton County,MO,1626,2285,659
45053,Jasper County,SC,4236,4892,656
47041,DeKalb County,TN,2491,3141,650
22121,West Baton Rouge Parish,LA,4778,5427,649
21215,Spencer County,KY,3305,3953,648
37145,Person County,NC,3295,3938,643
21179,Nelson County,KY,5451,6092,641
40041,Delaware County,OK,5584,6222,638
39083,Knox County,OH,6148,6784,636
13035,Butts County,GA,3619,4253,634
42129,Westmoreland County,PA,37341,37975,634
08019,Clear Creek County,CO,1491,2122,631
08119,Teller County,CO,4267,4897,630
17203,Woodford County,IL,5376,6006,630
26165,Wexford County,MI,3915,4543,628
48379,Rains County,TX,1535,2159,624
13171,Lamar County,GA,2582,3206,624
12093,Okeechobee County,FL,3460,4083,623
55027,Dodge County,WI,14942,15563,621
35061,Valencia County,NM,8434,9049,615
13133,Greene County,GA,1282,1897,615
17007,Boone County,IL,9579,10193,614
26091,Lenawee County,MI,10317,10926,609
36049,Lewis County,NY,2369,2978,609
31025,Cass County,NE,4619,5221,602
55015,Calumet County,WI,10996,11595,599
26001,Alcona County,MI,852,1444,592
48171,Gillespie County,TX,2419,3011,592
29187,St. Francois County,MO,7303,7894,591
17133,Monroe County,IL,4549,5138,589
18073,Jasper County,IN,4337,4924,587
22011,Beauregard Parish,LA,4215,4801,586
26027,Cass County,MI,8891,9473,582
13187,Lumpkin County,GA,4561,5138,577
17179,Tazewell County,IL,17266,17837,571
48031,Blanco County,TX,1381,1948,567
27111,Otter Tail County,MN,6304,6868,564
13231,Pike County,GA,2618,3180,562
48199,Hardin County,TX,8980,9540,560
48229,Hudspeth County,TX,416,971,555
51065,Fluvanna County,VA,3317,3870,553
27079,Le Sueur County,MN,5304,5857,553
08049,Grand County,CO,1722,2274,552
48281,Lampasas County,TX,3207,3756,549
30049,Lewis and Clark County,MT,7696,8243,547
40051,Grady County,OK,8770,9306,536
51023,Botetourt County,VA,5038,5573,535
55021,Columbia County,WI,11574,12109,535
53055,San Juan County,WA,1471,1998,527
55029,Door County,WI,2477,3004,527
37045,Cleveland County,NC,10247,10769,522
21015,Boone County,KY,27934,28451,517
26069,Iosco County,MI,2755,3272,517
24041,Talbot County,MD,4685,5200,515
13195,Madison County,GA,4245,4760,515
51193,Westmoreland County,VA,2106,2619,513
05143,Washington County,AR,35748,36260,512
06093,Siskiyou County,CA,3281,3790,509
26075,Jackson County,MI,15488,15997,509
41065,Wasco County,OR,2727,3233,506
17099,LaSalle County,IL,12875,13381,506
51053,Dinwiddie County,VA,4893,5398,505
20149,Pottawatomie County,KS,3089,3593,504
48223,Hopkins County,TX,3797,4299,502
41011,Coos County,OR,5999,6501,502
12043,Glades County,FL,1928,2429,501
55045,Green County,WI,4815,5315,500
12003,Baker County,FL,2814,3312,498
18029,Dearborn County,IN,7598,8087,489
27057,Hubbard County,MN,2532,3019,487
01021,Chilton County,AL,4386,4869,483
51685,Manassas Park city,VA,6609,7089,480
40113,Osage County,OK,9241,9720,479
26047,Emmet County,MI,4134,4613,479
48363,Palo Pinto County,TX,3505,3983,478
18061,Harrison County,IN,5437,5915,478
51043,Clarke County,VA,2553,3028,475
53059,Skamania County,WA,1442,1914,472
28115,Pontotoc County,MS,4007,4473,466
48337,Montague County,TX,2299,2764,465
51079,Greene County,VA,2427,2891,464
53047,Okanogan County,WA,4032,4492,460
23023,Sagadahoc County,ME,7152,7611,459
48297,Live Oak County,TX,1055,1513,458
29031,Cape Girardeau County,MO,8075,8532,457
08047,Gilpin County,CO,1055,1511,456
48051,Burleson County,TX,2064,2519,455
29029,Camden County,MO,6619,7073,454
37029,Camden County,NC,1340,1788,448
05085,Lonoke County,AR,12585,13032,447
13119,Franklin County,GA,3441,3876,435
06027,Inyo County,CA,1496,1930,434
26079,Kalkaska County,MI,2073,2505,432
32001,Churchill County,NV,2865,3297,432
47169,Trousdale County,TN,1530,1959,429
27041,Douglas County,MN,4162,4591,429
56033,Sheridan County,WY,2137,2565,428
55075,Marinette County,WI,4639,5065,426
36035,Fulton County,NY,5921,6345,424
13063,Clayton County,GA,98450,98872,422
08083,Montezuma County,CO,1802,2224,422
55135,Waupaca County,WI,7557,7979,422
26019,Benzie County,MI,2402,2822,420
13295,Walker County,GA,10160,10578,418
18033,DeKalb County,IN,6384,6800,416
48477,Washington County,TX,4181,4594,413
51175,Southampton County,VA,1773,2184,411
48059,Callahan County,TX,1818,2229,411
21073,Franklin County,KY,6721,7131,410
13159,Jasper County,GA,1742,2151,409
37113,Macon County,NC,1461,1869,408
23015,Lincoln County,ME,4427,4835,408
42079,Luzerne County,PA,29903,30307,404
13011,Banks County,GA,3475,3877,402
51155,Pulaski County,VA,3550,3947,397
31155,Saunders County,NE,3320,3717,397
47051,Franklin County,TN,4627,5024,397
18151,Steuben County,IN,4441,4838,397
25011,Franklin County,MA,9985,10381,396
17147,Piatt County,IL,2223,2618,395
47185,White County,TN,2943,3337,394
24011,Caroline County,MD,5147,5540,393
49029,Morgan County,UT,1428,1820,392
47015,Cannon County,TN,2118,2510,392
12027,DeSoto County,FL,3370,3762,392
13169,Jones County,GA,3896,4287,391
26051,Gladwin County,MI,3213,3604,391
26067,Ionia County,MI,9253,9642,389
56025,Natrona County,WY,7841,8229,388
26137,Otsego County,MI,2339,2727,388
16075,Payette County,ID,3483,3871,388
18149,Starke County,IN,3006,3390,384
04001,Apache County,AZ,12694,13075,381
01081,Lee County,AL,24314,24695,381
28109,Pearl River County,MS,5384,5763,379
06043,Mariposa County,CA,1766,2143,377
45037,Edgefield County,SC,3625,4002,377
31177,Washington County,NE,3020,3394,374
48287,Lee County,TX,1753,2125,372
21213,Simpson County,KY,2761,3130,369
27039,Dodge County,MN,2760,3127,367
21167,Mercer County,KY,2490,2855,365
01001,Autauga County,AL,9497,9861,364
48035,Bosque County,TX,2388,2752,364
48015,Austin County,TX,4433,4793,360
42007,Beaver County,PA,17463,17823,360
21199,Pulaski County,KY,3741,4100,359
51161,Roanoke County,VA,20285,20643,358
22031,De Soto Parish,LA,3382,3738,356
27017,Carlton County,MN,4181,4536,355
37151,Randolph County,NC,16641,16995,354
48457,Tyler County,TX,2052,2400,348
13045,Carroll County,GA,18187,18535,348
39167,Washington County,OH,4892,5240,348
13147,Hart County,GA,2584,2932,348
17141,Ogle County,IL,7003,7347,344
48149,Fayette County,TX,2425,2767,342
15007,Kauai County,HI,5207,5549,342
55137,Waushara County,WI,3429,3770,341
54077,Preston County,WV,2242,2582,340
40091,McIntosh County,OK,2353,2691,338
36113,Warren County,NY,10774,11111,337
21077,Gallatin County,KY,1509,1846,337
39123,Ottawa County,OH,5845,6181,336
48007,Aransas County,TX,4101,4434,333
13221,Oglethorpe County,GA,1878,2211,333
38105,Williams County,ND,5170,5501,331
47081,Hickman County,TN,3173,3503,330
51003,Albemarle County,VA,23022,23349,327
16015,Boise County,ID,1316,1642,326
13233,Polk County,GA,4965,5289,324
51007,Amelia County,VA,1484,1807,323
16081,Teton County,ID,732,1050,318
21089,Greenup County,KY,4006,4323,317
48349,Navarro County,TX,6204,6521,317
27061,Itasca County,MN,3230,3544,314
56023,Lincoln County,WY,1041,1355,314
54091,Taylor County,WV,2007,2319,312
01019,Cherokee County,AL,2211,2523,312
51119,Middlesex County,VA,609,921,312
42037,Columbia County,PA,6222,6534,312
18179,Wells County,IN,3331,3641,310
46099,Minnehaha County,SD,32881,33190,309
27095,Mille Lacs County,MN,5375,5684,309
26007,Alpena County,MI,1336,1643,307
53025,Grant County,WA,10507,10813,306
28039,George County,MS,2109,2414,305
16085,Valley County,ID,1457,1762,305
50013,Grand Isle County,VT,1444,1748,304
51610,Falls Church city,VA,4724,5026,302
12041,Gilchrist County,FL,2567,2865,298
22015,Bossier Parish,LA,25282,25579,297
51820,Waynesboro city,VA,5513,5808,295
51191,Washington County,VA,5403,5698,295
36053,Madison County,NY,9554,9849,295
30007,Broadwater County,MT,679,974,295
39087,Lawrence County,OH,5042,5336,294
51067,Franklin County,VA,5014,5307,293
45035,Dorchester County,SC,40114,40404,290
29225,Webster County,MO,5835,6124,289
18093,Lawrence County,IN,3684,3972,288
12133,Washington County,FL,3457,3744,287
32029,Storey County,NV,800,1087,287
35013,Do??a Ana County,NM,2708,2995,287
13241,Rabun County,GA,697,982,285
47085,Humphreys County,TN,1247,1531,284
06063,Plumas County,CA,1635,1919,284
42015,Bradford County,PA,4322,4605,283
21125,Laurel County,KY,6192,6473,281
21027,Breckinridge County,KY,2150,2431,281
13199,Meriwether County,GA,3519,3798,279
47035,Cumberland County,TN,3965,4244,279
18133,Putnam County,IN,5346,5624,278
26009,Antrim County,MI,3418,3696,278
34033,Salem County,NJ,8535,8813,278
12007,Bradford County,FL,3716,3993,277
20015,Butler County,KS,9439,9716,277
48331,Milam County,TX,2823,3100,277
36095,Schoharie County,NY,3031,3307,276
26155,Shiawassee County,MI,9653,9927,274
26039,Crawford County,MI,1008,1281,273
47121,Meigs County,TN,2199,2471,272
47061,Grundy County,TN,1154,1426,272
21079,Garrard County,KY,2859,3130,271
51011,Appomattox County,VA,1527,1798,271
26089,Leelanau County,MI,3338,3607,269
45059,Laurens County,SC,8572,8840,268
13229,Pierce County,GA,1990,2258,268
47107,McMinn County,TN,6113,6380,267
55057,Juneau County,WI,3529,3794,265
47145,Roane County,TN,7327,7590,263
47099,Lawrence County,TN,3089,3350,261
01033,Colbert County,AL,6774,7035,261
48455,Trinity County,TX,2205,2466,261
01067,Henry County,AL,2287,2546,259
18015,Carroll County,IN,3480,3735,255
23009,Hancock County,ME,4747,5002,255
51735,Poquoson city,VA,1654,1909,255
54065,Morgan County,WV,1558,1812,254
25003,Berkshire County,MA,8417,8670,253
21173,Montgomery County,KY,3205,3458,253
50023,Washington County,VT,7568,7818,250
20107,Linn County,KS,905,1155,250
48285,Lavaca County,TX,2110,2358,248
19031,Cedar County,IA,2709,2957,248
37115,Madison County,NC,2498,2745,247
41015,Curry County,OR,2162,2409,247
27065,Kanabec County,MN,2318,2563,245
53003,Asotin County,WA,3548,3793,245
21021,Boyle County,KY,4057,4301,244
39055,Geauga County,OH,14196,14439,243
19121,Madison County,IA,2219,2461,242
50017,Orange County,VT,4719,4960,241
21103,Henry County,KY,2663,2904,241
44001,Bristol County,RI,7833,8074,241
48237,Jack County,TX,653,892,239
19113,Linn County,IA,23656,23895,239
26119,Montmorency County,MI,798,1036,238
18145,Shelby County,IN,6909,7147,238
37139,Pasquotank County,NC,4533,4769,236
28141,Tishomingo County,MS,1447,1682,235
18013,Brown County,IN,2996,3231,235
13225,Peach County,GA,5271,5505,234
19015,Boone County,IA,3558,3792,234
37055,Dare County,NC,2449,2682,233
39141,Ross County,OH,7484,7717,233
51113,Madison County,VA,1323,1556,233
36117,Wayne County,NY,12393,12625,232
13173,Lanier County,GA,1532,1763,231
41001,Baker County,OR,720,948,228
30043,Jefferson County,MT,1814,2042,228
12051,Hendry County,FL,6206,6432,226
48073,Cherokee County,TX,5826,6051,225
21005,Anderson County,KY,3242,3464,222
13025,Brantley County,GA,1927,2148,221
28131,Stone County,MS,1976,2197,221
18119,Owen County,IN,3599,3819,220
55007,Bayfield County,WI,1202,1422,220
26101,Manistee County,MI,1990,2210,220
21003,Allen County,KY,2047,2266,219
18183,Whitley County,IN,5298,5516,218
17085,Jo Daviess County,IL,2148,2366,218
29131,Miller County,MO,3172,3389,217
54081,Raleigh County,WV,4389,4604,215
51163,Rockbridge County,VA,2216,2430,214
37111,McDowell County,NC,3266,3480,214
37199,Yancey County,NC,1258,1471,213
42115,Susquehanna County,PA,4193,4406,213
45073,Oconee County,SC,6606,6817,211
21239,Woodford County,KY,4107,4317,210
19017,Bremer County,IA,2863,3073,210
21187,Owen County,KY,1041,1250,209
47071,Hardin County,TN,1653,1861,208
18155,Switzerland County,IN,879,1085,206
21141,Logan County,KY,2502,2706,204
48425,Somervell County,TX,1018,1222,204
08027,Custer County,CO,207,409,202
48077,Clay County,TX,1431,1631,200
48395,Robertson County,TX,2100,2298,198
55077,Marquette County,WI,2378,2576,198
37009,Ashe County,NC,1256,1453,197
55129,Washburn County,WI,1727,1920,193
47053,Gibson County,TN,6507,6699,192
24019,Dorchester County,MD,3859,4051,192
47153,Sequatchie County,TN,1811,2001,190
01111,Randolph County,AL,1856,2046,190
49023,Juab County,UT,1316,1505,189
48089,Colorado County,TX,2392,2581,189
54055,Mercer County,WV,3037,3226,189
19059,Dickinson County,IA,1188,1376,188
05053,Grant County,AR,2172,2359,187
51081,Greensville County,VA,1077,1264,187
40099,Murray County,OK,1383,1570,187
21115,Johnson County,KY,1364,1550,186
54053,Mason County,WV,1951,2137,186
48403,Sabine County,TX,736,921,185
36011,Cayuga County,NY,7478,7663,185
48289,Leon County,TX,1887,2072,185
36115,Washington County,NY,9675,9860,185
29083,Henry County,MO,2639,2822,183
18171,Warren County,IN,1129,1309,180
51097,King and Queen County,VA,507,684,177
47101,Lewis County,TN,787,964,177
50027,Windsor County,VT,8352,8528,176
47127,Moore County,TN,906,1081,175
16041,Franklin County,ID,992,1166,174
50025,Windham County,VT,4571,4745,174
54025,Greenbrier County,WV,1605,1779,174
48239,Jackson County,TX,1543,1715,172
17103,Lee County,IL,4484,4656,172
12125,Union County,FL,1595,1766,171
51029,Buckingham County,VA,1048,1219,171
49039,Sanpete County,UT,2912,3083,171
36083,Rensselaer County,NY,29945,30116,171
28071,Lafayette County,MS,5274,5444,170
39139,Richland County,OH,12191,12360,169
47079,Henry County,TN,2288,2456,168
47103,Lincoln County,TN,3683,3848,165
47177,Warren County,TN,3530,3695,165
29049,Clinton County,MO,4591,4755,164
39047,Fayette County,OH,3890,4053,163
13281,Towns County,GA,759,920,161
51133,Northumberland County,VA,948,1108,160
32007,Elko County,NV,5511,5671,160
48009,Archer County,TX,1270,1429,159
42099,Perry County,PA,6075,6233,158
26105,Mason County,MI,2355,2512,157
19149,Plymouth County,IA,2420,2577,157
23027,Waldo County,ME,5136,5292,156
06101,Sutter County,CA,14552,14707,155
29073,Gasconade County,MO,1527,1682,155
27121,Pope County,MN,1012,1166,154
20087,Jefferson County,KS,2885,3038,153
29157,Perry County,MO,1484,1636,152
42005,Armstrong County,PA,7760,7912,152
37197,Yadkin County,NC,4402,4553,151
47173,Union County,TN,2934,3083,149
51035,Carroll County,VA,2647,2795,148
27093,Meeker County,MN,2958,3106,148
51790,Staunton city,VA,5711,5859,148
21061,Edmonson County,KY,1479,1626,147
02122,Kenai Peninsula Borough,AK,5017,5164,147
29167,Polk County,MO,3784,3931,147
21157,Marshall County,KY,3175,3322,147
45065,McCormick County,SC,494,640,146
05005,Baxter County,AR,2689,2834,145
29053,Cooper County,MO,1838,1982,144
21049,Clark County,KY,4720,4863,143
38053,McKenzie County,ND,848,991,143
37143,Perquimans County,NC,1339,1481,142
27049,Goodhue County,MN,6960,7098,138
13069,Coffee County,GA,2185,2323,138
26045,Eaton County,MI,26117,26254,137
21235,Whitley County,KY,4174,4310,136
13181,Lincoln County,GA,539,675,136
19075,Grundy County,IA,1371,1507,136
55113,Sawyer County,WI,819,954,135
05033,Crawford County,AR,8677,8811,134
13293,Upson County,GA,1704,1838,134
47057,Grainger County,TN,2917,3050,133
01093,Marion County,AL,2706,2839,133
22111,Union Parish,LA,2478,2610,132
19095,Iowa County,IA,1912,2044,132
47007,Bledsoe County,TN,1216,1347,131
40085,Love County,OK,1292,1423,131
29177,Ray County,MO,3665,3795,130
37169,Stokes County,NC,6222,6352,130
40095,Marshall County,OK,1445,1574,129
37175,Transylvania County,NC,2406,2535,129
18111,Newton County,IN,2146,2274,128
05087,Madison County,AR,2202,2330,128
47161,Stewart County,TN,1311,1438,127
25007,Dukes County,MA,1105,1231,126
48161,Freestone County,TX,1975,2099,124
26029,Charlevoix County,MI,3296,3419,123
37027,Caldwell County,NC,7545,7668,123
55067,Langlade County,WI,1232,1355,123
13019,Berrien County,GA,2216,2339,123
40125,Pottawatomie County,OK,10138,10259,121
39073,Hocking County,OH,3956,4076,120
29003,Andrew County,MO,3229,3349,120
37103,Jones County,NC,1750,1870,120
37039,Cherokee County,NC,1026,1145,119
19161,Sac County,IA,583,702,119
06051,Mono County,CA,1857,1975,118
54035,Jackson County,WV,1860,1977,117
21011,Bath County,KY,1180,1295,115
19071,Fremont County,IA,593,708,115
48159,Franklin County,TX,1412,1526,114
26063,Huron County,MI,2788,2902,114
37035,Catawba County,NC,21627,21741,114
31139,Pierce County,NE,494,607,113
21085,Grayson County,KY,2065,2177,112
51049,Cumberland County,VA,1230,1341,111
50009,Essex County,VT,861,972,111
16013,Blaine County,ID,1474,1584,110
51197,Wythe County,VA,1854,1964,110
17159,Richland County,IL,611,720,109
55039,Fond du Lac County,WI,13346,13454,108
40007,Beaver County,OK,277,384,107
36097,Schuyler County,NY,2547,2654,107
37121,Mitchell County,NC,1051,1158,107
54049,Marion County,WV,5077,5183,106
18143,Scott County,IN,3173,3279,106
12065,Jefferson County,FL,1508,1613,105
37003,Alexander County,NC,4180,4284,104
54029,Hancock County,WV,3640,3744,104
31093,Howard County,NE,544,648,104
56035,Sublette County,WY,279,383,104
47159,Smith County,TN,2500,2604,104
27157,Wabasha County,MN,2779,2882,103
30057,Madison County,MT,595,698,103
39091,Logan County,OH,6226,6328,102
30047,Lake County,MT,2505,2607,102
29185,St. Clair County,MO,610,712,102
19023,Butler County,IA,1388,1489,101
42087,Mifflin County,PA,2680,2781,101
28137,Tate County,MS,4276,4376,100
55115,Shawano County,WI,5810,5909,99
50015,Lamoille County,VT,3608,3707,99
17087,Johnson County,IL,858,955,97
01037,Coosa County,AL,1678,1775,97
21145,McCracken County,KY,6956,7053,97
48225,Houston County,TX,1862,1959,97
26135,Oscoda County,MI,246,342,96
29027,Callaway County,MO,6063,6159,96
19011,Benton County,IA,3628,3724,96
48175,Goliad County,TX,688,784,96
19183,Washington County,IA,2345,2440,95
32017,Lincoln County,NV,359,454,95
12067,Lafayette County,FL,466,561,95
21229,Washington County,KY,1191,1285,94
17039,De Witt County,IL,1876,1969,93
18159,Tipton County,IN,2374,2467,93
13149,Heard County,GA,1656,1749,93
18175,Washington County,IN,3488,3581,93
05105,Perry County,AR,1330,1422,92
17139,Moultrie County,IL,1956,2048,92
21063,Elliott County,KY,232,324,92
19109,Kossuth County,IA,496,588,92
26011,Arenac County,MI,1912,2003,91
39063,Hancock County,OH,9001,9092,91
01055,Etowah County,AL,9270,9361,91
27029,Clearwater County,MN,612,702,90
36107,Tioga County,NY,6586,6676,90
19195,Worth County,IA,751,840,89
19085,Harrison County,IA,1365,1454,89
48049,Brown County,TX,3147,3236,89
48313,Madison County,TX,1540,1629,89
51087,Henrico County,VA,81630,81719,89
13191,McIntosh County,GA,1224,1312,88
51063,Floyd County,VA,1085,1171,86
46019,Butte County,SD,1465,1550,85
45021,Cherokee County,SC,5526,5611,85
08065,Lake County,CO,621,706,85
21207,Russell County,KY,1117,1202,85
53043,Lincoln County,WA,1235,1319,84
21033,Caldwell County,KY,910,994,84
29023,Butler County,MO,3754,3837,83
54051,Marshall County,WV,2882,2964,82
20027,Clay County,KS,413,494,81
13075,Cook County,GA,2025,2106,81
55051,Iron County,WI,288,369,81
21123,Larue County,KY,2206,2286,80
39027,Clinton County,OH,7020,7100,80
20137,Norton County,KS,30,109,79
39033,Crawford County,OH,5718,5797,79
48277,Lamar County,TX,4177,4256,79
26141,Presque Isle County,MI,903,982,79
21009,Barren County,KY,4630,4708,78
21143,Lyon County,KY,482,560,78
30067,Park County,MT,1676,1754,78
27101,Murray County,MN,411,489,78
31167,Stanton County,NE,829,906,77
36041,Hamilton County,NY,42,119,77
46125,Turner County,SD,1047,1124,77
19165,Shelby County,IA,902,978,76
13049,Charlton County,GA,1005,1081,76
18107,Montgomery County,IN,4069,4145,76
51159,Richmond County,VA,860,934,74
23025,Somerset County,ME,6951,7025,74
12029,Dixie County,FL,1113,1187,74
26151,Sanilac County,MI,5394,5468,74
22021,Caldwell Parish,LA,649,722,73
38049,McHenry County,ND,505,578,73
47067,Hancock County,TN,107,179,72
21053,Clinton County,KY,367,439,72
16037,Custer County,ID,56,128,72
28009,Benton County,MS,1447,1519,72
13001,Appling County,GA,795,866,71
13079,Crawford County,GA,1906,1977,71
29111,Lewis County,MO,782,853,71
27097,Morrison County,MN,3993,4063,70
51036,Charles City County,VA,735,805,70
55049,Iowa County,WI,3759,3827,68
46061,Hanson County,SD,298,366,68
47005,Benton County,TN,1155,1223,68
05121,Randolph County,AR,1470,1538,68
51570,Colonial Heights city,VA,5632,5699,67
20003,Anderson County,KS,493,560,67
22049,Jackson Parish,LA,1457,1523,66
53069,Wahkiakum County,WA,273,339,66
51103,Lancaster County,VA,642,707,65
38097,Traill County,ND,920,985,65
51143,Pittsylvania County,VA,6765,6830,65
22125,West Feliciana Parish,LA,1111,1176,65
48241,Jasper County,TX,4608,4672,64
48001,Anderson County,TX,5197,5261,64
16049,Idaho County,ID,1091,1155,64
19043,Clayton County,IA,1658,1721,63
28019,Choctaw County,MS,578,641,63
29059,Dallas County,MO,2241,2304,63
47139,Polk County,TN,2391,2454,63
13027,Brooks County,GA,2485,2547,62
21221,Trigg County,KY,1041,1102,61
05059,Hot Spring County,AR,4191,4252,61
08055,Huerfano County,CO,379,440,61
29221,Washington County,MO,2830,2891,61
41035,Klamath County,OR,6531,6591,60
21087,Green County,KY,755,815,60
54017,Doddridge County,WV,634,694,60
30061,Mineral County,MT,403,463,60
29117,Livingston County,MO,815,874,59
19035,Cherokee County,IA,551,609,58
51071,Giles County,VA,1377,1435,58
46117,Stanley County,SD,635,693,58
51720,Norton city,VA,781,838,57
51139,Page County,VA,1576,1633,57
48093,Comanche County,TX,965,1022,57
29173,Ralls County,MO,1427,1483,56
28081,Lee County,MS,11213,11269,56
08091,Ouray County,CO,469,524,55
27063,Jackson County,MN,617,672,55
20117,Marshall County,KS,188,243,55
17037,DeKalb County,IL,18990,19045,55
20041,Dickinson County,KS,1912,1967,55
42117,Tioga County,PA,2641,2695,54
31121,Merrick County,NE,781,835,54
27033,Cottonwood County,MN,574,628,54
31031,Cherry County,NE,12,65,53
29085,Hickory County,MO,780,832,52
26153,Schoolcraft County,MI,125,177,52
26085,Lake County,MI,1326,1378,52
29039,Cedar County,MO,1182,1233,51
19099,Jasper County,IA,4732,4783,51
19131,Mitchell County,IA,414,465,51
18021,Clay County,IN,3720,3771,51
48205,Hartley County,TX,711,761,50
13283,Treutlen County,GA,282,331,49
46093,Meade County,SD,6880,6929,49
36077,Otsego County,NY,6248,6296,48
20143,Ottawa County,KS,602,650,48
17173,Shelby County,IL,2780,2827,47
05065,Izard County,AR,1091,1138,47
21191,Pendleton County,KY,2297,2344,47
18165,Vermillion County,IN,1929,1975,46
27081,Lincoln County,MN,292,336,44
08095,Phillips County,CO,65,109,44
29171,Putnam County,MO,39,83,44
18041,Fayette County,IN,1991,2034,43
30105,Valley County,MT,100,143,43
45017,Calhoun County,SC,2158,2201,43
19129,Mills County,IA,2013,2055,42
28127,Simpson County,MS,2939,2981,42
55073,Marathon County,WI,14776,14817,41
13201,Miller County,GA,423,464,41
16003,Adams County,ID,256,296,40
27087,Mahnomen County,MN,286,326,40
19135,Monroe County,IA,431,470,39
48385,Real County,TX,39,78,39
37005,Alleghany County,NC,173,212,39
40103,Noble County,OK,1314,1353,39
38055,McLean County,ND,1018,1057,39
05141,Van Buren County,AR,1295,1334,39
21099,Hart County,KY,1909,1947,38
19105,Jones County,IA,2132,2169,37
38075,Renville County,ND,321,358,37
42035,Clinton County,PA,3213,3250,37
48081,Coke County,TX,312,348,36
24029,Kent County,MD,2118,2154,36
13285,Troup County,GA,8550,8586,36
50019,Orleans County,VT,2033,2069,36
55047,Green Lake County,WI,2933,2969,36
54105,Wirt County,WV,544,579,35
17171,Scott County,IL,482,517,35
17091,Kankakee County,IL,10099,10133,34
47083,Houston County,TN,765,799,34
31169,Thayer County,NE,91,125,34
40045,Ellis County,OK,247,280,33
29107,Lafayette County,MO,4727,4759,32
21105,Hickman County,KY,121,153,32
30077,Powell County,MT,285,317,32
13249,Schley County,GA,352,384,32
16073,Owyhee County,ID,2017,2048,31
13023,Bleckley County,GA,1032,1062,30
18121,Parke County,IN,1882,1912,30
05013,Calhoun County,AR,219,249,30
36023,Cortland County,NY,4901,4930,29
19019,Buchanan County,IA,2282,2311,29
21023,Bracken County,KY,794,823,29
56011,Crook County,WY,603,631,28
30009,Carbon County,MT,1229,1257,28
02198,Prince of Wales-Hyder Census Area,AK,129,157,28
46053,Gregory County,SD,11,39,28
31099,Kearney County,NE,780,807,27
27011,Big Stone County,MN,52,79,27
21137,Lincoln County,KY,3280,3305,25
26013,Baraga County,MI,400,425,25
37095,Hyde County,NC,125,149,24
20017,Chase County,KS,128,152,24
31067,Gage County,NE,1925,1949,24
29175,Randolph County,MO,2066,2090,24
33007,Coos County,NH,2872,2896,24
19041,Clay County,IA,1280,1303,23
01007,Bibb County,AL,2676,2699,23
18123,Perry County,IN,1397,1419,22
29125,Maries County,MO,1049,1071,22
55099,Price County,WI,546,568,22
08073,Lincoln County,CO,109,131,22
39001,Adams County,OH,2249,2271,22
38065,Oliver County,ND,10,31,21
26113,Missaukee County,MI,1502,1523,21
31097,Johnson County,NE,260,281,21
17129,Menard County,IL,1657,1678,21
20123,Mitchell County,KS,91,112,21
28061,Jasper County,MS,2090,2111,21
46033,Custer County,SD,944,964,20
17169,Schuyler County,IL,425,445,20
49001,Beaver County,UT,354,374,20
31073,Gosper County,NE,125,145,20
48193,Hamilton County,TX,716,736,20
22059,La Salle Parish,LA,290,310,20
48483,Wheeler County,TX,54,74,20
27031,Cook County,MN,259,278,19
18055,Greene County,IN,4019,4038,19
22043,Grant Parish,LA,2940,2959,19
48411,San Saba County,TX,12,31,19
24045,Wicomico County,MD,12875,12894,19
54031,Hardy County,WV,845,864,19
29063,DeKalb County,MO,1582,1601,19
31083,Harlan County,NE,12,31,19
20207,Woodson County,KS,35,54,19
20197,Wabaunsee County,KS,828,847,19
19145,Page County,IA,932,951,19
06091,Sierra County,CA,120,138,18
21181,Nicholas County,KY,531,549,18
08025,Crowley County,CO,154,172,18
28079,Leake County,MS,2334,2352,18
17025,Clay County,IL,880,898,18
46003,Aurora County,SD,77,95,18
37075,Graham County,NC,102,119,17
31125,Nance County,NE,88,105,17
08121,Washington County,CO,94,111,17
18065,Henry County,IN,6166,6182,16
31107,Knox County,NE,176,192,16
31051,Dixon County,NE,398,414,16
26071,Iron County,MI,274,289,15
01061,Geneva County,AL,3110,3125,15
46055,Haakon County,SD,12,27,15
20167,Russell County,KS,359,373,14
48271,Kinney County,TX,64,78,14
54097,Upshur County,WV,1557,1571,14
28015,Carroll County,MS,1165,1179,14
16007,Bear Lake County,ID,56,70,14
13125,Glascock County,GA,27,41,14
20047,Edwards County,KS,26,40,14
31133,Pawnee County,NE,11,25,14
51009,Amherst County,VA,3960,3973,13
30089,Sanders County,MT,500,513,13
48317,Martin County,TX,607,620,13
20119,Meade County,KS,28,41,13
31165,Sioux County,NE,29,42,13
55037,Florence County,WI,376,389,13
46009,Bon Homme County,SD,332,345,13
46129,Walworth County,SD,50,62,12
48419,Shelby County,TX,1820,1832,12
20171,Scott County,KS,24,36,12
38023,Divide County,ND,23,35,12
48253,Jones County,TX,2193,2205,12
48315,Marion County,TX,1409,1421,12
18047,Franklin County,IN,3293,3304,11
41063,Wallowa County,OR,105,116,11
38081,Sargent County,ND,219,230,11
31147,Richardson County,NE,121,132,11
21237,Wolfe County,KY,69,79,10
46047,Fall River County,SD,541,551,10
48243,Jeff Davis County,TX,11,21,10
31143,Polk County,NE,375,385,10
28003,Alcorn County,MS,2773,2783,10
27155,Traverse County,MN,34,44,10
13307,Webster County,GA,43,53,10
19093,Ida County,IA,276,286,10
51125,Nelson County,VA,1504,1514,10
26083,Keweenaw County,MI,226,236,10
19007,Appanoose County,IA,373,382,9
48043,Brewster County,TX,294,303,9
48351,Newton County,TX,1659,1668,9
51051,Dickenson County,VA,613,622,9
47089,Jefferson County,TN,9213,9222,9
20157,Republic County,KS,15,24,9
20165,Rush County,KS,73,82,9
31105,Kimball County,NE,71,80,9
05023,Cleburne County,AR,2837,2846,9
47135,Perry County,TN,76,84,8
27159,Wadena County,MN,1907,1915,8
20201,Washington County,KS,72,80,8
55053,Jackson County,WI,2197,2205,8
49033,Rich County,UT,14,21,7
02068,Denali Borough,AK,65,72,7
20185,Stafford County,KS,78,85,7
31021,Burt County,NE,501,508,7
16059,Lemhi County,ID,24,30,6
29109,Lawrence County,MO,6317,6323,6
38043,Kidder County,ND,119,125,6
46041,Dewey County,SD,95,101,6
49055,Wayne County,UT,11,17,6
54107,Wood County,WV,5728,5733,5
51181,Surry County,VA,295,300,5
54023,Grant County,WV,751,756,5
32009,Esmeralda County,NV,10,15,5
56019,Johnson County,WY,681,685,4
39121,Noble County,OH,1012,1016,4
32011,Eureka County,NV,56,60,4
31175,Valley County,NE,21,25,4
13007,Baker County,GA,88,92,4
42033,Clearfield County,PA,6136,6140,4
31113,Logan County,NE,11,15,4
28069,Kemper County,MS,813,817,4
41055,Sherman County,OR,27,30,3
21031,Butler County,KY,1017,1020,3
08007,Archuleta County,CO,564,567,3
02164,Lake and Peninsula Borough,AK,17,20,3
46085,Lyman County,SD,50,53,3
20069,Gray County,KS,359,362,3
47023,Chester County,TN,1839,1842,3
13239,Quitman County,GA,154,157,3
40061,Haskell County,OK,777,780,3
40059,Harper County,OK,60,63,3
48087,Collingsworth County,TX,10,12,2
16051,Jefferson County,ID,4657,4659,2
48431,Sterling County,TX,10,12,2
13043,Candler County,GA,1020,1022,2
28007,Attala County,MS,884,886,2
05063,Independence County,AR,3226,3228,2
31135,Perkins County,NE,13,15,2
54071,Pendleton County,WV,89,91,2
31137,Phelps County,NE,554,556,2
05025,Cleveland County,AR,489,490,1
48119,Delta County,TX,546,547,1
51017,Bath County,VA,44,45,1
38047,Logan County,ND,21,22,1
47025,Claiborne County,TN,2200,2201,1
39011,Auglaize County,OH,6065,6066,1
37011,Avery County,NC,1288,1289,1
13265,Taliaferro County,GA,10,11,1
37043,Clay County,NC,815,816,1
22059,LaSalle Parish,LA,468,469,1
35057,Torrance County,NM,1876,1877,1
38031,Foster County,ND,13,13,0
46007,Bennett County,SD,12,12,0
27107,Norman County,MN,603,603,0
20081,Haskell County,KS,44,44,0
54007,Braxton County,WV,346,346,0
48011,Armstrong County,TX,76,76,0
54057,Mineral County,WV,2222,2222,0
05129,Searcy County,AR,186,186,0
21163,Meade County,KY,5077,5077,0
30051,Liberty County,MT,13,13,0
08009,Baca County,CO,10,10,0
38103,Wells County,ND,42,42,0
38085,Sioux County,ND,78,78,0
31061,Franklin County,NE,10,10,0
49025,Kane County,UT,667,667,0
46017,Buffalo County,SD,11,10,-1
48283,La Salle County,TX,273,272,-1
31173,Thurston County,NE,242,241,-1
05039,Dallas County,AR,279,278,-1
48333,Mills County,TX,37,36,-1
08063,Kit Carson County,CO,60,59,-1
46071,Jackson County,SD,26,25,-1
31063,Frontier County,NE,50,49,-1
31087,Hitchcock County,NE,104,103,-1
17155,Putnam County,IL,785,784,-1
27125,Red Lake County,MN,350,349,-1
02100,Haines Borough,AK,11,10,-1
20089,Jewell County,KS,11,10,-1
38011,Bowman County,ND,12,11,-1
48421,Sherman County,TX,13,12,-1
27077,Lake of the Woods County,MN,36,35,-1
13099,Early County,GA,454,453,-1
56017,Hot Springs County,WY,100,99,-1
46089,McPherson County,SD,13,12,-1
30091,Sheridan County,MT,13,11,-2
46137,Ziebach County,SD,13,11,-2
48295,Lipscomb County,TX,17,15,-2
40025,Cimarron County,OK,12,10,-2
20127,Morris County,KS,95,93,-2
20025,Clark County,KS,31,29,-2
30079,Prairie County,MT,12,10,-2
29207,Stoddard County,MO,2922,2920,-2
20189,Stevens County,KS,44,42,-2
51185,Tazewell County,VA,2592,2590,-2
37157,Rockingham County,NC,8953,8951,-2
29035,Carter County,MO,423,420,-3
08109,Saguache County,CO,330,327,-3
05043,Drew County,AR,1530,1527,-3
53023,Garfield County,WA,13,10,-3
48173,Glasscock County,TX,13,10,-3
17049,Effingham County,IL,2806,2803,-3
28057,Itawamba County,MS,3193,3189,-4
31101,Keith County,NE,303,299,-4
30107,Wheatland County,MT,14,10,-4
38013,Burke County,ND,63,59,-4
05049,Fulton County,AR,1124,1120,-4
01023,Choctaw County,AL,220,216,-4
47175,Van Buren County,TN,584,580,-4
51157,Rappahannock County,VA,869,865,-4
20063,Gove County,KS,14,10,-4
20053,Ellsworth County,KS,261,257,-4
13197,Marion County,GA,511,507,-4
20147,Phillips County,KS,60,56,-4
48275,Knox County,TX,64,60,-4
27055,Houston County,MN,1946,1942,-4
16079,Shoshone County,ID,1184,1179,-5
17153,Pulaski County,IL,198,193,-5
29093,Iron County,MO,997,992,-5
48105,Crockett County,TX,70,65,-5
31049,Deuel County,NE,18,13,-5
40057,Harmon County,OK,36,31,-5
19051,Davis County,IA,424,419,-5
21059,Daviess County,KY,7317,7312,-5
37177,Tyrrell County,NC,15,10,-5
13317,Wilkes County,GA,106,100,-6
53013,Columbia County,WA,339,333,-6
08033,Dolores County,CO,18,12,-6
38041,Hettinger County,ND,103,97,-6
46031,Corson County,SD,53,47,-6
19151,Pocahontas County,IA,267,261,-6
40117,Pawnee County,OK,2528,2522,-6
48129,Donley County,TX,26,20,-6
35027,Lincoln County,NM,1905,1899,-6
27069,Kittson County,MN,56,49,-7
38007,Billings County,ND,40,33,-7
48083,Coleman County,TX,559,552,-7
46025,Clark County,SD,146,139,-7
48191,Hall County,TX,27,20,-7
39127,Perry County,OH,5523,5516,-7
13161,Jeff Davis County,GA,858,851,-7
21025,Breathitt County,KY,318,311,-7
08125,Yuma County,CO,169,162,-7
21201,Robertson County,KY,34,27,-7
40053,Grant County,OK,363,356,-7
41023,Grant County,OR,41,33,-8
20105,Lincoln County,KS,49,41,-8
13315,Wilcox County,GA,228,220,-8
05029,Conway County,AR,2470,2462,-8
31129,Nuckolls County,NE,57,49,-8
30039,Granite County,MT,160,152,-8
39005,Ashland County,OH,6813,6805,-8
37149,Polk County,NC,2640,2632,-8
20141,Osborne County,KS,20,12,-8
08023,Costilla County,CO,21,12,-9
48023,Baylor County,TX,41,32,-9
51115,Mathews County,VA,618,609,-9
48125,Dickens County,TX,32,23,-9
48247,Jim Hogg County,TX,69,60,-9
29129,Mercer County,MO,22,13,-9
38019,Cavalier County,ND,23,14,-9
46111,Sanborn County,SD,67,58,-9
21039,Carlisle County,KY,334,325,-9
42067,Juniata County,PA,1919,1910,-9
41037,Lake County,OR,186,177,-9
47109,McNairy County,TN,2505,2495,-10
21129,Lee County,KY,79,69,-10
46045,Edmunds County,SD,401,391,-10
38069,Pierce County,ND,45,35,-10
40043,Dewey County,OK,219,209,-10
46039,Deuel County,SD,159,149,-10
48235,Irion County,TX,165,154,-11
48165,Gaines County,TX,1246,1235,-11
21161,Mason County,KY,1618,1607,-11
48305,Lynn County,TX,802,791,-11
35015,Eddy County,NM,4989,4978,-11
46091,Marshall County,SD,75,64,-11
31123,Morrill County,NE,420,409,-11
08115,Sedgwick County,CO,21,10,-11
20083,Hodgeman County,KS,38,27,-11
30097,Sweet Grass County,MT,53,41,-12
20145,Pawnee County,KS,344,332,-12
40055,Greer County,OK,247,235,-12
48461,Upton County,TX,67,55,-12
20195,Trego County,KS,70,58,-12
27023,Chippewa County,MN,1137,1125,-12
29205,Shelby County,MO,174,161,-13
17107,Logan County,IL,2595,2582,-13
31163,Sherman County,NE,34,21,-13
41025,Harney County,OR,47,34,-13
20163,Rooks County,KS,182,169,-13
25019,Nantucket County,MA,763,750,-13
19003,Adams County,IA,84,71,-13
45071,Newberry County,SC,3441,3428,-13
20181,Sherman County,KS,62,48,-14
39115,Morgan County,OH,1371,1357,-14
48359,Oldham County,TX,135,121,-14
16071,Oneida County,ID,38,24,-14
47029,Cocke County,TN,3215,3201,-14
01069,Houston County,AL,13573,13558,-15
54021,Gilmer County,WV,130,115,-15
55031,Douglas County,WI,4373,4358,-15
48095,Concho County,TX,191,176,-15
37123,Montgomery County,NC,2933,2918,-15
31011,Boone County,NE,100,85,-15
27173,Yellow Medicine County,MN,793,777,-16
20109,Logan County,KS,72,56,-16
39021,Champaign County,OH,6360,6344,-16
54073,Pleasants County,WV,572,556,-16
31035,Clay County,NE,480,464,-16
20039,Decatur County,KS,26,10,-16
19087,Henry County,IA,1819,1803,-16
35059,Union County,NM,34,17,-17
35033,Mora County,NM,325,308,-17
26095,Luce County,MI,52,35,-17
18125,Pike County,IN,1515,1498,-17
46073,Jerauld County,SD,44,27,-17
46115,Spink County,SD,314,297,-17
49017,Garfield County,UT,131,114,-17
46119,Sully County,SD,47,30,-17
27149,Stevens County,MN,228,211,-17
48267,Kimble County,TX,56,38,-18
19083,Hardin County,IA,1334,1316,-18
27073,Lac qui Parle County,MN,144,126,-18
20193,Thomas County,KS,145,127,-18
31027,Cedar County,NE,325,307,-18
48123,DeWitt County,TX,2282,2264,-18
21189,Owsley County,KY,58,39,-19
46121,Todd County,SD,169,150,-19
13251,Screven County,GA,1242,1223,-19
02105,Hoonah-Angoon Census Area,AK,50,31,-19
21127,Lawrence County,KY,1107,1088,-19
19159,Ringgold County,IA,61,41,-20
02063,Chugach Census Area,AK,50,29,-21
06041,Marin County,CA,51153,51132,-21
46067,Hutchinson County,SD,317,296,-21
19173,Taylor County,IA,204,183,-21
30045,Judith Basin County,MT,51,30,-21
29135,Moniteau County,MO,1640,1619,-21
17117,Macoupin County,IL,5839,5818,-21
38037,Grant County,ND,47,25,-22
56045,Weston County,WY,227,205,-22
21065,Estill County,KY,942,920,-22
27085,McLeod County,MN,4942,4920,-22
20131,Nemaha County,KS,415,393,-22
29005,Atchison County,MO,56,34,-22
28063,Jefferson County,MS,483,461,-22
31181,Webster County,NE,231,208,-23
27075,Lake County,MN,1027,1004,-23
22107,Tensas Parish,LA,76,53,-23
20007,Barber County,KS,74,51,-23
28117,Prentiss County,MS,2547,2524,-23
46015,Brule County,SD,127,104,-23
20093,Kearny County,KS,352,328,-24
51045,Craig County,VA,222,198,-24
48195,Hansford County,TX,60,36,-24
26159,Van Buren County,MI,12159,12135,-24
51025,Brunswick County,VA,977,953,-24
19089,Howard County,IA,534,510,-24
02220,Sitka City and Borough,AK,262,237,-25
29057,Dade County,MO,681,656,-25
54093,Tucker County,WV,389,364,-25
31007,Banner County,NE,37,12,-25
27133,Rock County,MN,736,711,-25
01029,Cleburne County,AL,1638,1612,-26
37137,Pamlico County,NC,1031,1005,-26
13115,Floyd County,GA,9190,9164,-26
50001,Addison County,VT,4474,4448,-26
38021,Dickey County,ND,60,34,-26
20067,Grant County,KS,76,49,-27
48435,Sutton County,TX,103,76,-27
21159,Martin County,KY,239,212,-27
38063,Nelson County,ND,68,41,-27
05109,Pike County,AR,1054,1027,-27
19001,Adair County,IA,752,725,-27
27051,Grant County,MN,627,599,-28
13131,Grady County,GA,2462,2434,-28
29013,Bates County,MO,1753,1725,-28
13101,Echols County,GA,470,442,-28
46123,Tripp County,SD,39,11,-28
18181,White County,IN,3753,3724,-29
29103,Knox County,MO,85,56,-29
48079,Cochran County,TX,132,103,-29
29163,Pike County,MO,1410,1381,-29
39079,Jackson County,OH,2676,2647,-29
38045,LaMoure County,ND,91,61,-30
31041,Custer County,NE,448,418,-30
13309,Wheeler County,GA,215,185,-30
20019,Chautauqua County,KS,95,65,-30
13209,Montgomery County,GA,953,923,-30
28095,Monroe County,MS,3464,3433,-31
28037,Franklin County,MS,404,373,-31
54095,Tyler County,WV,665,634,-31
54009,Brooke County,WV,2704,2673,-31
30099,Teton County,MT,438,407,-31
19157,Poweshiek County,IA,1734,1703,-31
31161,Sheridan County,NE,55,24,-31
08107,Routt County,CO,2689,2657,-32
28085,Lincoln County,MS,2450,2418,-32
16029,Caribou County,ID,294,262,-32
01041,Crenshaw County,AL,1449,1417,-32
21097,Harrison County,KY,1834,1802,-32
38091,Steele County,ND,61,29,-32
39135,Preble County,OH,5358,5326,-32
51515,Bedford city,VA,402,369,-33
17009,Brown County,IL,265,232,-33
50003,Bennington County,VT,2660,2627,-33
42109,Snyder County,PA,3892,3859,-33
08003,Alamosa County,CO,1779,1746,-33
29179,Reynolds County,MO,119,86,-33
48413,Schleicher County,TX,145,112,-33
30005,Blaine County,MT,357,324,-33
21135,Lewis County,KY,622,589,-33
51031,Campbell County,VA,10239,10206,-33
48429,Stephens County,TX,154,120,-34
19185,Wayne County,IA,175,141,-34
46113,Shannon County,SD,244,210,-34
02013,Aleutians East Borough,AK,96,62,-34
18139,Rush County,IN,2623,2589,-34
42057,Fulton County,PA,1298,1263,-35
48401,Rusk County,TX,8203,8168,-35
02195,Petersburg Census Area,AK,61,25,-36
26003,Alger County,MI,505,469,-36
21155,Marion County,KY,1761,1725,-36
48357,Ochiltree County,TX,178,142,-36
26131,Ontonagon County,MI,74,38,-36
55041,Forest County,WI,292,256,-36
46057,Hamlin County,SD,580,543,-37
30023,Deer Lodge County,MT,649,612,-37
26043,Dickinson County,MI,1745,1708,-37
17073,Henry County,IL,5930,5893,-37
30095,Stillwater County,MT,1110,1073,-37
17069,Hardin County,IL,73,36,-37
39105,Meigs County,OH,1748,1711,-37
28145,Union County,MS,3588,3550,-38
17011,Bureau County,IL,3470,3432,-38
05047,Franklin County,AR,2159,2121,-38
28041,Greene County,MS,1083,1045,-38
38029,Emmons County,ND,138,100,-38
54013,Calhoun County,WV,103,64,-39
42013,Blair County,PA,7093,7054,-39
13259,Stewart County,GA,218,179,-39
42053,Forest County,PA,306,267,-39
19177,Van Buren County,IA,328,289,-39
28111,Perry County,MS,1420,1381,-39
54075,Pocahontas County,WV,73,34,-39
21119,Knott County,KY,893,854,-39
29007,Audrain County,MO,2384,2345,-39
16045,Gem County,ID,2523,2483,-40
17123,Marshall County,IL,1748,1708,-40
13267,Tattnall County,GA,2062,2022,-40
13065,Clinch County,GA,120,80,-40
48197,Hardeman County,TX,145,105,-40
56043,Washakie County,WY,136,96,-40
17053,Ford County,IL,1926,1886,-40
48383,Reagan County,TX,122,82,-40
42023,Cameron County,PA,124,84,-40
13305,Wayne County,GA,1820,1779,-41
40129,Roger Mills County,OK,216,175,-41
28099,Neshoba County,MS,2308,2267,-41
26097,Mackinac County,MI,612,570,-42
48343,Morris County,TX,1714,1672,-42
12077,Liberty County,FL,594,552,-42
29199,Scotland County,MO,86,44,-42
47133,Overton County,TN,2494,2451,-43
12013,Calhoun County,FL,1390,1347,-43
48151,Fisher County,TX,158,115,-43
21057,Cumberland County,KY,95,52,-43
08103,Rio Blanco County,CO,352,309,-43
13003,Atkinson County,GA,686,643,-43
19133,Monona County,IA,619,575,-44
08011,Bent County,CO,200,156,-44
21223,Trimble County,KY,1465,1421,-44
13269,Taylor County,GA,284,239,-45
06049,Modoc County,CA,221,176,-45
47039,Decatur County,TN,794,749,-45
39071,Highland County,OH,6075,6030,-45
27143,Sibley County,MN,2021,1976,-45
17013,Calhoun County,IL,119,74,-45
47001,Anderson County,TN,12940,12894,-46
29079,Grundy County,MO,381,335,-46
19137,Montgomery County,IA,677,631,-46
19077,Guthrie County,IA,1511,1465,-46
17083,Jersey County,IL,3053,3007,-46
31033,Cheyenne County,NE,235,189,-46
16077,Power County,ID,894,848,-46
06029,Kern County,CA,80744,80698,-46
13087,Decatur County,GA,1911,1865,-46
05009,Boone County,AR,3342,3295,-47
28155,Webster County,MS,780,733,-47
18137,Ripley County,IN,4199,4152,-47
29197,Schuyler County,MO,339,292,-47
30021,Dawson County,MT,281,233,-48
48417,Shackelford County,TX,200,152,-48
29123,Madison County,MO,1084,1036,-48
31081,Hamilton County,NE,1010,962,-48
37193,Wilkes County,NC,4399,4351,-48
51135,Nottoway County,VA,1218,1169,-49
05011,Bradley County,AR,462,413,-49
55091,Pepin County,WI,855,806,-49
19141,O'Brien County,IA,1151,1102,-49
51640,Galax city,VA,1472,1423,-49
29061,Daviess County,MO,479,430,-49
36019,Clinton County,NY,3955,3905,-50
13167,Johnson County,GA,730,680,-50
18161,Union County,IN,1038,988,-50
40105,Nowata County,OK,1307,1257,-50
35051,Sierra County,NM,767,717,-50
27089,Marshall County,MN,915,865,-50
02016,Aleutians West Census Area,AK,180,130,-50
48065,Carson County,TX,1034,983,-51
18129,Posey County,IN,3569,3518,-51
17059,Gallatin County,IL,324,273,-51
18031,Decatur County,IN,3717,3666,-51
13113,Fayette County,GA,21524,21473,-51
40063,Hughes County,OK,1145,1094,-51
05073,Lafayette County,AR,389,338,-51
51005,Alleghany County,VA,1305,1254,-51
28119,Quitman County,MS,559,507,-52
20031,Coffey County,KS,504,452,-52
39039,Defiance County,OH,4618,4566,-52
01011,Bullock County,AL,778,726,-52
21069,Fleming County,KY,1079,1027,-52
48207,Haskell County,TX,370,318,-52
47027,Clay County,TN,443,391,-52
38009,Bottineau County,ND,429,377,-52
30101,Toole County,MT,148,96,-52
02270,Wade Hampton Census Area,AK,201,148,-53
19009,Audubon County,IA,207,154,-53
29115,Linn County,MO,602,549,-53
48399,Runnels County,TX,1004,951,-53
13107,Emanuel County,GA,1518,1464,-54
13263,Talbot County,GA,765,711,-54
28101,Newton County,MS,2025,1971,-54
13243,Randolph County,GA,132,78,-54
46037,Day County,SD,227,173,-54
13127,Glynn County,GA,7874,7820,-54
46023,Charles Mix County,SD,174,120,-54
01017,Chambers County,AL,4870,4816,-54
29089,Howard County,MO,1194,1139,-55
31065,Furnas County,NE,108,53,-55
55123,Vernon County,WI,3447,3392,-55
02158,Kusilvak Census Area,AK,229,174,-55
20013,Brown County,KS,466,411,-55
30065,Musselshell County,MT,494,439,-55
19107,Keokuk County,IA,1022,967,-55
04011,Greenlee County,AZ,1239,1183,-56
24023,Garrett County,MD,1402,1346,-56
21153,Magoffin County,KY,289,233,-56
51141,Patrick County,VA,1087,1031,-56
19147,Palo Alto County,IA,578,522,-56
53019,Ferry County,WA,660,603,-57
35037,Quay County,NM,255,198,-57
18007,Benton County,IN,1124,1067,-57
29081,Harrison County,MO,184,127,-57
08021,Conejos County,CO,434,376,-58
29017,Bollinger County,MO,1327,1269,-58
30093,Silver Bow County,MT,3192,3134,-58
32021,Mineral County,NV,185,127,-58
18051,Gibson County,IN,3863,3804,-59
17135,Montgomery County,IL,2646,2587,-59
39163,Vinton County,OH,1394,1335,-59
36031,Essex County,NY,4022,3963,-59
30001,Beaverhead County,MT,372,313,-59
21139,Livingston County,KY,1338,1278,-60
49027,Millard County,UT,868,808,-60
48107,Crosby County,TX,802,742,-60
12059,Holmes County,FL,2482,2422,-60
37033,Caswell County,NC,3170,3109,-61
47137,Pickett County,TN,251,190,-61
22053,Jefferson Davis Parish,LA,3857,3796,-61
48133,Eastland County,TX,1240,1179,-61
29045,Clark County,MO,346,284,-62
30015,Chouteau County,MT,345,283,-62
47077,Henderson County,TN,2612,2550,-62
13037,Calhoun County,GA,169,107,-62
19123,Mahaska County,IA,2116,2054,-62
31127,Nemaha County,NE,442,380,-62
32027,Pershing County,NV,584,522,-62
26127,Oceana County,MI,3679,3617,-62
08099,Prowers County,CO,242,180,-62
49013,Duchesne County,UT,2377,2315,-62
48335,Mitchell County,TX,397,334,-63
40141,Tillman County,OK,321,258,-63
17041,Douglas County,IL,2509,2446,-63
05079,Lincoln County,AR,849,786,-63
48307,McCulloch County,TX,228,164,-64
31003,Antelope County,NE,413,349,-64
18025,Crawford County,IN,1310,1246,-64
19175,Union County,IA,820,756,-64
39015,Brown County,OH,7755,7691,-64
51117,Mecklenburg County,VA,2029,1965,-64
27091,Martin County,MN,1029,964,-65
12079,Madison County,FL,1100,1035,-65
19037,Chickasaw County,IA,985,920,-65
19117,Lucas County,IA,621,556,-65
29025,Caldwell County,MO,1061,996,-65
48099,Coryell County,TX,18886,18820,-66
21091,Hancock County,KY,1196,1130,-66
48387,Red River County,TX,1187,1121,-66
20073,Greenwood County,KS,390,324,-66
29065,Dent County,MO,758,692,-66
29009,Barry County,MO,5488,5422,-66
46109,Roberts County,SD,328,262,-66
31023,Butler County,NE,753,686,-67
28125,Sharkey County,MS,169,102,-67
48293,Limestone County,TX,2283,2216,-67
47055,Giles County,TN,3411,3344,-67
32013,Humboldt County,NV,1725,1658,-67
29033,Carroll County,MO,250,183,-67
29075,Gentry County,MO,219,151,-68
48003,Andrews County,TX,1442,1374,-68
35019,Guadalupe County,NM,191,123,-68
50005,Caledonia County,VT,3277,3208,-69
42105,Potter County,PA,1042,973,-69
30073,Pondera County,MT,189,120,-69
51111,Lunenburg County,VA,900,831,-69
54041,Lewis County,WV,1424,1355,-69
21109,Jackson County,KY,964,895,-69
16063,Lincoln County,ID,566,497,-69
48103,Crane County,TX,371,302,-69
49015,Emery County,UT,806,736,-70
20205,Wilson County,KS,702,632,-70
40149,Washita County,OK,1678,1608,-70
17023,Clark County,IL,1436,1366,-70
28093,Marshall County,MS,5990,5920,-70
40029,Coal County,OK,555,484,-71
22037,East Feliciana Parish,LA,2802,2731,-71
12063,Jackson County,FL,4425,4354,-71
19081,Hancock County,IA,1140,1069,-71
29217,Vernon County,MO,1536,1464,-72
28129,Smith County,MS,1933,1861,-72
47033,Crockett County,TN,1989,1917,-72
20077,Harper County,KS,370,298,-72
29211,Sullivan County,MO,289,216,-73
19039,Clarke County,IA,1028,955,-73
01057,Fayette County,AL,1655,1582,-73
53051,Pend Oreille County,WA,1950,1877,-73
05091,Miller County,AR,7920,7847,-73
05113,Polk County,AR,291,218,-73
40067,Jefferson County,OK,458,385,-73
51021,Bland County,VA,269,195,-74
54015,Clay County,WV,588,514,-74
39119,Muskingum County,OH,7786,7712,-74
41061,Union County,OR,1765,1691,-74
38025,Dunn County,ND,500,426,-74
31059,Fillmore County,NE,337,262,-75
42083,McKean County,PA,1980,1905,-75
26053,Gogebic County,MI,415,340,-75
21007,Ballard County,KY,889,813,-76
47091,Johnson County,TN,656,580,-76
29141,Morgan County,MO,2494,2418,-76
51057,Essex County,VA,765,688,-77
28005,Amite County,MS,1061,984,-77
17101,Lawrence County,IL,1121,1044,-77
19189,Winnebago County,IA,912,835,-77
30085,Roosevelt County,MT,259,182,-77
01031,Coffee County,AL,7920,7843,-77
24039,Somerset County,MD,2689,2612,-77
19143,Osceola County,IA,383,305,-78
48169,Garza County,TX,444,366,-78
17131,Mercer County,IL,2093,2015,-78
17193,White County,IL,800,722,-78
21133,Letcher County,KY,645,567,-78
40033,Cotton County,OK,623,545,-78
20151,Pratt County,KS,338,259,-79
19197,Wright County,IA,757,678,-79
13257,Stephens County,GA,2430,2351,-79
29151,Osage County,MO,1115,1035,-80
19055,Delaware County,IA,1828,1747,-81
06011,Colusa County,CA,1826,1744,-82
46101,Moody County,SD,740,658,-82
13235,Pulaski County,GA,765,683,-82
21171,Monroe County,KY,525,443,-82
39051,Fulton County,OH,5933,5851,-82
40003,Alfalfa County,OK,309,227,-82
29203,Shannon County,MO,523,440,-83
13109,Evans County,GA,1113,1030,-83
05099,Nevada County,AR,709,625,-84
26133,Osceola County,MI,3062,2978,-84
54067,Nicholas County,WV,1243,1158,-85
13155,Irwin County,GA,1307,1222,-85
20159,Rice County,KS,779,694,-85
05147,Woodruff County,AR,418,333,-85
51077,Grayson County,VA,1481,1395,-86
48391,Refugio County,TX,507,421,-86
39031,Coshocton County,OH,3477,3391,-86
42097,Northumberland County,PA,10445,10358,-87
06021,Glenn County,CA,3084,2997,-87
05137,Stone County,AR,266,178,-88
01121,Talladega County,AL,9854,9766,-88
17079,Jasper County,IL,676,588,-88
37073,Gates County,NC,642,553,-89
47075,Haywood County,TN,2191,2102,-89
29139,Montgomery County,MO,1449,1360,-89
28097,Montgomery County,MS,788,699,-89
40127,Pushmataha County,OK,572,482,-90
51089,Henry County,VA,5389,5299,-90
38079,Rolette County,ND,429,339,-90
19005,Allamakee County,IA,816,725,-91
32033,White Pine County,NV,685,594,-91
21165,Menifee County,KY,465,374,-91
21055,Crittenden County,KY,426,335,-91
40079,Le Flore County,OK,4185,4094,-91
28161,Yalobusha County,MS,1530,1439,-91
29121,Macon County,MO,1156,1064,-92
18117,Orange County,IN,1723,1631,-92
13303,Washington County,GA,531,439,-92
16087,Washington County,ID,1202,1110,-92
27045,Fillmore County,MN,2315,2222,-93
19027,Carroll County,IA,1387,1294,-93
27117,Pipestone County,MN,420,327,-93
39131,Pike County,OH,3021,2928,-93
46077,Kingsbury County,SD,337,244,-93
28139,Tippah County,MS,1936,1843,-93
48145,Falls County,TX,2016,1922,-94
38005,Benson County,ND,449,355,-94
55009,Brown County,WI,31578,31484,-94
56015,Goshen County,WY,887,792,-95
46102,Oglala Lakota County,SD,504,409,-95
29119,McDonald County,MO,3709,3614,-95
22083,Richland Parish,LA,2254,2159,-95
40037,Creek County,OK,13893,13798,-95
17165,Saline County,IL,1512,1417,-95
31045,Dawes County,NE,161,65,-96
01075,Lamar County,AL,948,852,-96
01133,Winston County,AL,2763,2667,-96
05097,Montgomery County,AR,669,573,-96
56031,Platte County,WY,485,389,-96
48067,Cass County,TX,3209,3112,-97
54101,Webster County,WV,361,264,-97
40093,Major County,OK,596,499,-97
16021,Boundary County,ID,877,780,-97
21001,Adair County,KY,1186,1088,-98
20139,Osage County,KS,2175,2077,-98
21233,Webster County,KY,1568,1470,-98
22057,Lafourche Parish,LA,11573,11475,-98
17187,Warren County,IL,1639,1540,-99
51670,Hopewell city,VA,6281,6182,-99
13301,Warren County,GA,536,437,-99
35023,Hidalgo County,NM,136,37,-99
29087,Holt County,MO,192,93,-99
46051,Grant County,SD,332,232,-100
21175,Morgan County,KY,331,231,-100
51580,Covington city,VA,1054,954,-100
47181,Wayne County,TN,877,776,-101
51530,Buena Vista city,VA,940,839,-101
28053,Humphreys County,MS,319,218,-101
13277,Tift County,GA,4762,4660,-102
22117,Washington Parish,LA,3502,3400,-102
32015,Lander County,NV,378,276,-102
28025,Clay County,MS,1823,1720,-103
22085,Sabine Parish,LA,1392,1289,-103
30053,Lincoln County,MT,1058,955,-103
47151,Scott County,TN,606,503,-103
29137,Monroe County,MO,1026,923,-103
48127,Dimmit County,TX,794,690,-104
45081,Saluda County,SC,2854,2750,-104
18045,Fountain County,IN,2533,2429,-104
40075,Kiowa County,OK,460,356,-104
05117,Prairie County,AR,796,692,-104
28065,Jefferson Davis County,MS,1366,1261,-105
47123,Monroe County,TN,5459,5353,-106
31013,Box Butte County,NE,308,202,-106
01039,Covington County,AL,2338,2232,-106
20115,Marion County,KS,1046,938,-108
06015,Del Norte County,CA,1566,1458,-108
20133,Neosho County,KS,1468,1360,-108
17033,Crawford County,IL,705,597,-108
21217,Taylor County,KY,2177,2069,-108
19191,Winneshiek County,IA,1049,941,-108
17055,Franklin County,IL,3708,3600,-108
29149,Oregon County,MO,826,717,-109
48069,Castro County,TX,363,254,-109
17047,Edwards County,IL,611,502,-109
16035,Clearwater County,ID,572,462,-110
48177,Gonzales County,TX,1897,1787,-110
17035,Cumberland County,IL,1375,1265,-110
31039,Cuming County,NE,392,281,-111
08089,Otero County,CO,1350,1238,-112
29055,Crawford County,MO,3198,3086,-112
55107,Rusk County,WI,1305,1193,-112
37013,Beaufort County,NC,4312,4199,-113
17081,Jefferson County,IL,2914,2801,-113
37041,Chowan County,NC,869,756,-113
02070,Dillingham Census Area,AK,313,200,-113
21045,Casey County,KY,1060,946,-114
42111,Somerset County,PA,4823,4708,-115
20095,Kingman County,KS,918,803,-115
54099,Wayne County,WV,4357,4242,-115
19053,Decatur County,IA,480,365,-115
18069,Huntington County,IN,4211,4095,-116
56003,Big Horn County,WY,746,630,-116
17175,Stark County,IL,648,532,-116
18049,Fulton County,IN,2396,2280,-116
27167,Wilkin County,MN,1105,989,-116
31131,Otoe County,NE,2145,2028,-117
55061,Kewaunee County,WI,2577,2460,-117
48365,Panola County,TX,2378,2260,-118
54001,Barbour County,WV,1422,1304,-118
01131,Wilcox County,AL,581,463,-118
21075,Fulton County,KY,653,535,-118
22113,Vermilion Parish,LA,7247,7128,-119
47095,Lake County,TN,630,511,-119
48503,Young County,TX,1076,956,-120
01053,Escambia County,AL,3229,3109,-120
55078,Menominee County,WI,549,428,-121
17151,Pope County,IL,246,125,-121
13273,Terrell County,GA,1013,891,-122
27113,Pennington County,MN,1401,1279,-122
19119,Lyon County,IA,802,680,-122
29041,Chariton County,MO,444,321,-123
18103,Miami County,IN,4425,4302,-123
27135,Roseau County,MN,429,306,-123
54087,Roane County,WV,980,857,-123
05081,Little River County,AR,1214,1091,-123
22025,Catahoula Parish,LA,691,567,-124
29223,Wayne County,MO,1095,971,-124
48437,Swisher County,TX,763,639,-124
05061,Howard County,AR,1353,1228,-125
19091,Humboldt County,IA,663,538,-125
39161,Van Wert County,OH,3186,3060,-126
13141,Hancock County,GA,479,352,-127
13105,Elbert County,GA,1488,1361,-127
40107,Okfuskee County,OK,817,690,-127
27005,Becker County,MN,4260,4133,-127
05135,Sharp County,AR,2150,2023,-127
12037,Franklin County,FL,565,437,-128
13189,McDuffie County,GA,2361,2233,-128
46087,McCook County,SD,647,519,-128
54089,Summers County,WV,953,825,-128
18153,Sullivan County,IN,2063,1934,-129
13081,Crisp County,GA,1821,1692,-129
08075,Logan County,CO,1539,1410,-129
54063,Monroe County,WV,1248,1118,-130
51131,Northampton County,VA,1143,1013,-130
05101,Newton County,AR,689,558,-131
21177,Muhlenberg County,KY,1745,1614,-131
49047,Uintah County,UT,3407,3276,-131
01035,Conecuh County,AL,963,832,-131
30035,Glacier County,MT,568,437,-131
13165,Jenkins County,GA,566,434,-132
37185,Warren County,NC,2352,2220,-132
37079,Greene County,NC,2764,2631,-133
45001,Abbeville County,SC,2924,2791,-133
36015,Chemung County,NY,7409,7276,-133
21169,Metcalfe County,KY,967,834,-133
21219,Todd County,KY,1301,1168,-133
08081,Moffat County,CO,844,711,-133
42113,Sullivan County,PA,574,441,-133
17071,Henderson County,IL,598,464,-134
42071,Lancaster County,PA,50792,50658,-134
26157,Tuscola County,MI,6963,6829,-134
18131,Pulaski County,IN,1369,1235,-134
48063,Camp County,TX,1465,1331,-134
48495,Winkler County,TX,483,349,-134
20043,Doniphan County,KS,776,642,-134
22081,Red River Parish,LA,807,673,-134
04009,Graham County,AZ,3347,3212,-135
21183,Ohio County,KY,2290,2155,-135
39081,Jefferson County,OH,5125,4990,-135
39043,Erie County,OH,10792,10657,-135
40151,Woods County,OK,353,217,-136
38073,Ransom County,ND,465,329,-136
28153,Wayne County,MS,1703,1567,-136
40005,Atoka County,OK,1087,951,-136
38077,Richland County,ND,1799,1662,-137
12045,Gulf County,FL,1286,1149,-137
13005,Bacon County,GA,700,563,-137
47087,Jackson County,TN,1414,1276,-138
48389,Reeves County,TX,912,774,-138
18115,Ohio County,IN,1140,1001,-139
27151,Swift County,MN,624,484,-140
40023,Choctaw County,OK,1367,1227,-140
49041,Sevier County,UT,1917,1776,-141
13275,Thomas County,GA,4535,4393,-142
19115,Louisa County,IA,1395,1253,-142
37017,Bladen County,NC,3192,3049,-143
42039,Crawford County,PA,7099,6956,-143
12123,Taylor County,FL,830,687,-143
42123,Warren County,PA,2481,2338,-143
21203,Rockcastle County,KY,1359,1216,-143
48153,Floyd County,TX,688,545,-143
29186,Ste. Genevieve County,MO,2585,2442,-143
37161,Rutherford County,NC,4777,4633,-144
13289,Twiggs County,GA,1270,1126,-144
42093,Montour County,PA,3123,2979,-144
48017,Bailey County,TX,582,438,-144
55103,Richland County,WI,2204,2059,-145
17065,Hamilton County,IL,569,424,-145
26023,Branch County,MI,4597,4452,-145
51595,Emporia city,VA,1068,922,-146
28031,Covington County,MS,2465,2319,-146
28159,Winston County,MS,1002,856,-146
13017,Ben Hill County,GA,1433,1286,-147
17127,Massac County,IL,1002,855,-147
21197,Powell County,KY,1184,1036,-148
31145,Red Willow County,NE,350,202,-148
45023,Chester County,SC,4012,3864,-148
21131,Leslie County,KY,348,200,-148
17005,Bond County,IL,1772,1624,-148
51167,Russell County,VA,2078,1930,-148
19029,Cass County,IA,874,724,-150
19067,Floyd County,IA,1361,1211,-150
47019,Carter County,TN,7568,7417,-151
13271,Telfair County,GA,802,651,-151
05071,Johnson County,AR,2043,1891,-152
31095,Jefferson County,NE,611,459,-152
47049,Fentress County,TN,931,779,-152
48255,Karnes County,TX,1131,979,-152
55119,Taylor County,WI,1695,1542,-153
51683,Manassas city,VA,15716,15563,-153
05089,Marion County,AR,1683,1529,-154
19097,Jackson County,IA,2041,1887,-154
47017,Carroll County,TN,3391,3237,-154
19073,Greene County,IA,568,413,-155
20085,Jackson County,KS,1488,1333,-155
28157,Wilkinson County,MS,524,369,-155
55033,Dunn County,WI,6464,6309,-155
56041,Uinta County,WY,1390,1234,-156
36121,Wyoming County,NY,5308,5151,-157
30027,Fergus County,MT,687,530,-157
55121,Trempealeau County,WI,4040,3883,-157
55023,Crawford County,WI,1794,1636,-158
13091,Dodge County,GA,1414,1256,-158
23007,Franklin County,ME,3782,3624,-158
45025,Chesterfield County,SC,3659,3501,-158
18101,Martin County,IN,969,811,-158
20055,Finney County,KS,2107,1948,-159
31159,Seward County,NE,1969,1810,-159
04012,La Paz County,AZ,2070,1911,-159
22041,Franklin Parish,LA,1307,1147,-160
12047,Hamilton County,FL,1226,1066,-160
22099,St. Martin Parish,LA,8730,8570,-160
47131,Obion County,TN,3051,2890,-161
16009,Benewah County,ID,871,709,-162
17027,Clinton County,IL,4513,4350,-163
22035,East Carroll Parish,LA,418,255,-163
29091,Howell County,MO,2706,2543,-163
21083,Graves County,KY,3127,2963,-164
27071,Koochiching County,MN,396,232,-164
20059,Franklin County,KS,3635,3471,-164
19079,Hamilton County,IA,1612,1448,-164
40135,Sequoyah County,OK,4032,3867,-165
55069,Lincoln County,WI,2815,2650,-165
31089,Holt County,NE,292,126,-166
18079,Jennings County,IN,4037,3870,-167
47171,Unicoi County,TN,2163,1995,-168
18077,Jefferson County,IN,2925,2757,-168
48475,Ward County,TX,1021,853,-168
01013,Butler County,AL,1186,1017,-169
54027,Hampshire County,WV,1943,1773,-170
26041,Delta County,MI,1791,1621,-170
05067,Jackson County,AR,1404,1234,-170
54019,Fayette County,WV,3458,3288,-170
48487,Wilbarger County,TX,839,669,-170
40035,Craig County,OK,1776,1605,-171
17045,Edgar County,IL,1410,1239,-171
48507,Zavala County,TX,948,777,-171
17015,Carroll County,IL,1495,1323,-172
51147,Prince Edward County,VA,2153,1980,-173
55117,Sheboygan County,WI,10741,10568,-173
28087,Lowndes County,MS,4862,4688,-174
40069,Johnston County,OK,1260,1086,-174
31185,York County,NE,1150,976,-174
39013,Belmont County,OH,5352,5177,-175
06105,Trinity County,CA,899,724,-175
51690,Martinsville city,VA,2871,2696,-175
21147,McCreary County,KY,686,510,-176
24001,Allegany County,MD,3780,3604,-176
19063,Emmet County,IA,549,372,-177
21041,Carroll County,KY,1290,1113,-177
18009,Blackford County,IN,1576,1398,-178
47115,Marion County,TN,2943,2764,-179
13279,Toombs County,GA,2296,2116,-180
38067,Pembina County,ND,497,316,-181
21149,McLean County,KY,1187,1005,-182
55011,Buffalo County,WI,1712,1530,-182
06035,Lassen County,CA,2224,2041,-183
51037,Charlotte County,VA,908,725,-183
29181,Ripley County,MO,1023,840,-183
30087,Rosebud County,MT,616,433,-183
02110,Juneau City and Borough,AK,2575,2390,-185
30083,Richland County,MT,764,579,-185
21019,Boyd County,KY,5611,5426,-185
26033,Chippewa County,MI,1084,899,-185
22127,Winn Parish,LA,770,584,-186
42009,Bedford County,PA,3169,2983,-186
17145,Perry County,IL,2026,1840,-186
05077,Lee County,AR,622,435,-187
26059,Hillsdale County,MI,5174,4987,-187
30017,Custer County,MT,567,379,-188
42119,Union County,PA,4419,4230,-189
55065,Lafayette County,WI,2460,2271,-189
51678,Lexington city,VA,1015,824,-191
28013,Calhoun County,MS,800,607,-193
54083,Randolph County,WV,1507,1314,-193
17075,Iroquois County,IL,3314,3120,-194
13299,Ware County,GA,3609,3414,-195
08051,Gunnison County,CO,1370,1174,-196
05037,Cross County,AR,1772,1576,-196
13055,Chattooga County,GA,1874,1678,-196
47013,Campbell County,TN,2983,2787,-196
01063,Greene County,AL,836,640,-196
36099,Seneca County,NY,4127,3931,-196
55093,Pierce County,WI,7411,7215,-196
39053,Gallia County,OH,1989,1793,-196
27127,Redwood County,MN,1326,1129,-197
22123,West Carroll Parish,LA,776,579,-197
48115,Dawson County,TX,899,702,-197
29201,Scott County,MO,5591,5393,-198
02130,Ketchikan Gateway Borough,AK,634,436,-198
22027,Claiborne Parish,LA,1261,1063,-198
51620,Franklin city,VA,1742,1544,-198
13093,Dooly County,GA,1031,832,-199
48463,Uvalde County,TX,2058,1858,-200
55003,Ashland County,WI,1180,979,-201
27047,Freeborn County,MN,2639,2438,-201
37117,Martin County,NC,2218,2016,-202
46135,Yankton County,SD,2002,1800,-202
40147,Washington County,OK,5813,5610,-203
35007,Colfax County,NM,464,261,-203
48131,Duval County,TX,1320,1117,-203
23021,Piscataquis County,ME,1589,1384,-205
21225,Union County,KY,1000,794,-206
13253,Seminole County,GA,877,671,-206
17191,Wayne County,IL,959,753,-206
23013,Knox County,ME,3891,3685,-206
42047,Elk County,PA,1575,1368,-207
05021,Clay County,AR,1485,1278,-207
01049,DeKalb County,AL,6443,6235,-208
01107,Pickens County,AL,1523,1314,-209
40019,Carter County,OK,5166,4957,-209
50021,Rutland County,VT,4436,4227,-209
13321,Worth County,GA,2842,2633,-209
48405,San Augustine County,TX,814,604,-210
26107,Mecosta County,MI,6116,5906,-210
48163,Frio County,TX,1419,1209,-210
51105,Lee County,VA,872,661,-211
17105,Livingston County,IL,4006,3795,-211
51083,Halifax County,VA,1507,1296,-211
08105,Rio Grande County,CO,1173,961,-212
41049,Morrow County,OR,1319,1107,-212
51520,Bristol city,VA,3828,3615,-213
37007,Anson County,NC,2253,2040,-213
19025,Calhoun County,IA,864,650,-214
08087,Morgan County,CO,3175,2960,-215
39067,Harrison County,OH,1697,1482,-215
21231,Wayne County,KY,1195,979,-216
02180,Nome Census Area,AK,587,370,-217
30003,Big Horn County,MT,884,667,-217
40139,Texas County,OK,1393,1176,-217
21017,Bourbon County,KY,3048,2831,-217
45069,Marlboro County,SC,1695,1477,-218
48505,Zapata County,TX,641,423,-218
56007,Carbon County,WY,1304,1086,-218
08071,Las Animas County,CO,828,609,-219
29011,Barton County,MO,1012,792,-220
55081,Monroe County,WI,4890,4669,-221
39059,Guernsey County,OH,3366,3145,-221
40097,Mayes County,OK,5078,4856,-222
29097,Jasper County,MO,16136,15914,-222
37091,Hertford County,NC,1666,1443,-223
22013,Bienville Parish,LA,1921,1698,-223
27161,Waseca County,MN,2476,2253,-223
13213,Murray County,GA,5195,4971,-224
17137,Morgan County,IL,3066,2842,-224
28147,Walthall County,MS,1355,1130,-225
42065,Jefferson County,PA,4503,4278,-225
27165,Watonwan County,MN,899,674,-225
05075,Lawrence County,AR,2014,1788,-226
47143,Rhea County,TN,3147,2919,-228
42073,Lawrence County,PA,7802,7574,-228
16069,Nez Perce County,ID,6321,6093,-228
29105,Laclede County,MO,3176,2948,-228
05001,Arkansas County,AR,1301,1071,-230
20011,Bourbon County,KS,866,636,-230
40077,Latimer County,OK,1018,787,-231
39019,Carroll County,OH,4333,4101,-232
39143,Sandusky County,OH,7796,7564,-232
28107,Panola County,MS,3801,3569,-232
06055,Napa County,CA,23091,22859,-232
05095,Monroe County,AR,471,238,-233
45005,Allendale County,SC,789,556,-233
17021,Christian County,IL,3194,2960,-234
51183,Sussex County,VA,1161,927,-234
26111,Midland County,MI,11101,10867,-234
47097,Lauderdale County,TN,2506,2271,-235
05017,Chicot County,AR,871,636,-235
42061,Huntingdon County,PA,3448,3213,-235
01099,Monroe County,AL,1415,1178,-237
39175,Wyandot County,OH,3007,2770,-237
38099,Walsh County,ND,979,742,-237
13319,Wilkinson County,GA,1025,787,-238
05127,Scott County,AR,895,655,-240
47141,Putnam County,TN,10068,9828,-240
17125,Mason County,IL,1752,1512,-240
05133,Sevier County,AR,993,750,-243
45009,Bamberg County,SC,1306,1063,-243
08067,La Plata County,CO,7161,6917,-244
29133,Mississippi County,MO,1206,962,-244
01027,Clay County,AL,1337,1092,-245
19111,Lee County,IA,2485,2240,-245
21043,Carter County,KY,1853,1608,-245
22029,Concordia Parish,LA,1634,1388,-246
54103,Wetzel County,WV,1161,914,-247
48111,Dallam County,TX,1055,808,-247
45087,Union County,SC,1854,1607,-247
56009,Converse County,WY,1361,1113,-248
18113,Noble County,IN,7685,7435,-250
49019,Grand County,UT,820,569,-251
19069,Franklin County,IA,897,645,-252
31141,Platte County,NE,3893,3641,-252
16067,Minidoka County,ID,3001,2749,-252
51775,Salem city,VA,6724,6472,-252
01091,Marengo County,AL,1511,1258,-253
22023,Cameron Parish,LA,1332,1079,-253
31179,Wayne County,NE,823,569,-254
02240,Southeast Fairbanks Census Area,AK,744,490,-254
21095,Harlan County,KY,539,284,-255
17149,Pike County,IL,764,509,-255
45027,Clarendon County,SC,3366,3111,-255
28077,Lawrence County,MS,949,694,-255
51169,Scott County,VA,1956,1700,-256
29215,Texas County,MO,2166,1910,-256
18085,Kosciusko County,IN,9650,9394,-256
47059,Greene County,TN,4918,4660,-258
35006,Cibola County,NM,2571,2313,-258
16061,Lewis County,ID,847,589,-258
39107,Mercer County,OH,3404,3146,-258
48481,Wharton County,TX,4745,4487,-258
38089,Stark County,ND,3325,3067,-258
48501,Yoakum County,TX,691,432,-259
21081,Grant County,KY,5198,4939,-259
02185,North Slope Borough,AK,620,360,-260
27043,Faribault County,MN,1250,989,-261
39171,Williams County,OH,3699,3438,-261
17067,Hancock County,IL,1666,1404,-262
40133,Seminole County,OK,3232,2970,-262
28043,Grenada County,MS,1936,1673,-263
27153,Todd County,MN,3341,3077,-264
29145,Newton County,MO,11165,10901,-264
48445,Terry County,TX,1053,789,-264
17189,Washington County,IL,1929,1664,-265
33009,Grafton County,NH,16939,16674,-265
40089,McCurtain County,OK,1237,972,-265
13175,Laurens County,GA,2840,2573,-267
47129,Morgan County,TN,2200,1932,-268
29127,Marion County,MO,3265,2997,-268
17051,Fayette County,IL,1823,1555,-268
29209,Stone County,MO,5343,5075,-268
48037,Bowie County,TX,11897,11628,-269
17185,Wabash County,IL,842,572,-270
48371,Pecos County,TX,1087,817,-270
16043,Fremont County,ID,1627,1357,-270
35025,Lea County,NM,5719,5446,-273
17017,Cass County,IL,1415,1142,-273
37131,Northampton County,NC,1917,1644,-273
22077,Pointe Coupee Parish,LA,2351,2076,-275
28103,Noxubee County,MS,766,490,-276
38057,Mercer County,ND,693,417,-276
17121,Marion County,IL,3576,3298,-278
05041,Desha County,AR,1292,1013,-279
17003,Alexander County,IL,647,367,-280
48179,Gray County,TX,1588,1308,-280
45029,Colleton County,SC,4079,3799,-280
22089,St. Charles Parish,LA,8434,8153,-281
01129,Washington County,AL,1703,1422,-281
48369,Parmer County,TX,1067,785,-282
38003,Barnes County,ND,985,703,-282
13083,Dade County,GA,2080,1798,-282
48233,Hutchinson County,TX,1716,1433,-283
39065,Hardin County,OH,3573,3289,-284
46005,Beadle County,SD,832,548,-284
19155,Pottawattamie County,IA,12140,11856,-284
13287,Turner County,GA,1002,717,-285
54005,Boone County,WV,1648,1362,-286
17057,Fulton County,IL,3087,2801,-286
47113,Madison County,TN,13652,13366,-286
20001,Allen County,KS,853,566,-287
19171,Tama County,IA,2048,1761,-287
47179,Washington County,TN,19590,19303,-287
19047,Crawford County,IA,1073,786,-287
27129,Renville County,MN,1450,1163,-287
28029,Copiah County,MS,2807,2519,-288
26057,Gratiot County,MI,4699,4410,-289
29067,Douglas County,MO,1367,1078,-289
26109,Menominee County,MI,2519,2229,-290
02188,Northwest Arctic Borough,AK,631,341,-290
51750,Radford city,VA,2901,2608,-293
01071,Jackson County,AL,4596,4303,-293
39125,Paulding County,OH,2371,2078,-293
48047,Brooks County,TX,681,387,-294
01079,Lawrence County,AL,4114,3819,-295
47045,Dyer County,TN,3515,3220,-295
56029,Park County,WY,2264,1966,-298
19101,Jefferson County,IA,1255,956,-299
28135,Tallahatchie County,MS,1250,951,-299
22003,Allen Parish,LA,2630,2331,-299
54085,Ritchie County,WV,753,453,-300
29153,Ozark County,MO,771,471,-300
17157,Randolph County,IL,2879,2579,-300
01105,Perry County,AL,748,448,-300
45049,Hampton County,SC,1664,1363,-301
40001,Adair County,OK,2300,1999,-301
40111,Okmulgee County,OK,5023,4721,-302
18037,Dubois County,IN,3764,3460,-304
36003,Allegany County,NY,3889,3583,-306
26149,St. Joseph County,MI,6897,6590,-307
22065,Madison Parish,LA,774,467,-307
39111,Monroe County,OH,968,661,-307
36033,Franklin County,NY,3472,3165,-307
18001,Adams County,IN,2672,2363,-309
40011,Blaine County,OK,827,518,-309
48353,Nolan County,TX,1291,981,-310
54043,Lincoln County,WV,2027,1716,-311
46029,Codington County,SD,2733,2422,-311
08113,San Miguel County,CO,495,184,-311
34005,Burlington County,NJ,79383,79071,-312
28021,Claiborne County,MS,815,503,-312
44005,Newport County,RI,14709,14390,-319
35055,Taos County,NM,2244,1924,-320
20021,Cherokee County,KS,2731,2409,-322
37173,Swain County,NC,1876,1554,-322
29155,Pemiscot County,MO,1487,1165,-322
49007,Carbon County,UT,1868,1545,-323
18075,Jay County,IN,2035,1709,-326
53071,Walla Walla County,WA,6802,6475,-327
51001,Accomack County,VA,2383,2055,-328
37099,Jackson County,NC,4148,3820,-328
16031,Cassia County,ID,3232,2903,-329
19061,Dubuque County,IA,7813,7484,-329
20113,McPherson County,KS,2851,2522,-329
42085,Mercer County,PA,9304,8974,-330
38071,Ramsey County,ND,1131,800,-331
21121,Knox County,KY,3802,3471,-331
05003,Ashley County,AR,984,650,-334
05057,Hempstead County,AR,2061,1727,-334
37187,Washington County,NC,774,440,-334
01085,Lowndes County,AL,1772,1438,-334
22091,St. Helena Parish,LA,2649,2314,-335
20191,Sumner County,KS,3515,3180,-335
17001,Adams County,IL,3518,3178,-340
13193,Macon County,GA,1037,697,-340
42121,Venango County,PA,4337,3996,-341
01065,Hale County,AL,2143,1802,-341
45039,Fairfield County,SC,2936,2595,-341
27103,Nicollet County,MN,7421,7079,-342
36051,Livingston County,NY,8154,7811,-343
13163,Jefferson County,GA,1155,812,-343
47063,Hamblen County,TN,7950,7606,-344
19045,Clinton County,IA,5042,4697,-345
36123,Yates County,NY,2857,2512,-345
27027,Clay County,MN,12097,11752,-345
29143,New Madrid County,MO,2836,2488,-348
48415,Scurry County,TX,1023,674,-349
41045,Malheur County,OR,2997,2647,-350
05045,Faulkner County,AR,17391,17041,-350
18067,Howard County,IN,9217,8867,-350
21037,Campbell County,KY,19559,19208,-351
22093,St. James Parish,LA,2465,2114,-351
46035,Davison County,SD,1954,1602,-352
01123,Tallapoosa County,AL,5499,5147,-352
48279,Lamb County,TX,1377,1025,-352
45031,Darlington County,SC,7119,6766,-353
19125,Marion County,IA,3431,3078,-353
36037,Genesee County,NY,7245,6892,-353
05103,Ouachita County,AR,1760,1407,-353
54109,Wyoming County,WV,888,534,-354
41027,Hood River County,OR,3420,3065,-355
40049,Garvin County,OK,3410,3055,-355
39069,Henry County,OH,3766,3411,-355
45061,Lee County,SC,2375,2015,-360
35028,Los Alamos County,NM,1969,1608,-361
23029,Washington County,ME,1925,1562,-363
02290,Yukon-Koyukuk Census Area,AK,870,506,-364
38093,Stutsman County,ND,1579,1211,-368
22001,Acadia Parish,LA,8327,7957,-370
42031,Clarion County,PA,3442,3072,-370
17177,Stephenson County,IL,4221,3849,-372
28017,Chickasaw County,MS,2273,1900,-373
18147,Spencer County,IN,2853,2480,-373
21051,Clay County,KY,1136,763,-373
28067,Jones County,MS,6778,6405,-373
29001,Adair County,MO,1673,1299,-374
20005,Atchison County,KS,1251,877,-374
28023,Clarke County,MS,1868,1494,-374
17061,Greene County,IL,1420,1045,-375
16053,Jerome County,ID,3982,3607,-375
51173,Smyth County,VA,1969,1593,-376
13205,Mitchell County,GA,2319,1943,-376
28163,Yazoo County,MS,1984,1606,-378
48309,McLennan County,TX,28469,28091,-378
05015,Carroll County,AR,2655,2276,-379
37195,Wilson County,NC,8828,8449,-379
01127,Walker County,AL,5181,4800,-381
20079,Harvey County,KS,4444,4063,-381
27015,Brown County,MN,2156,1774,-382
27009,Benton County,MN,12457,12075,-382
46081,Lawrence County,SD,3830,3448,-382
29229,Wright County,MO,2425,2043,-382
21101,Henderson County,KY,4362,3979,-383
29195,Saline County,MO,1594,1208,-386
21013,Bell County,KY,1745,1359,-386
38061,Mountrail County,ND,1130,743,-387
17195,Whiteside County,IL,5396,5008,-388
21205,Rowan County,KY,2481,2093,-388
22039,Evangeline Parish,LA,3340,2951,-389
37181,Vance County,NC,5187,4797,-390
28091,Marion County,MS,2117,1726,-391
05083,Logan County,AR,2187,1796,-391
40073,Kingfisher County,OK,1916,1524,-392
47073,Hawkins County,TN,7602,7210,-392
13071,Colquitt County,GA,3480,3088,-392
47069,Hardeman County,TN,2309,1914,-395
06023,Humboldt County,CA,14512,14117,-395
18023,Clinton County,IN,4128,3732,-396
42069,Lackawanna County,PA,19091,18694,-397
05111,Poinsett County,AR,3035,2637,-398
17181,Union County,IL,1197,797,-400
21035,Calloway County,KY,3065,2663,-402
55071,Manitowoc County,WI,7412,7009,-403
49043,Summit County,UT,8597,8193,-404
45033,Dillon County,SC,2420,2016,-404
18099,Marshall County,IN,5910,5505,-405
28059,Jackson County,MS,18358,17952,-406
13033,Burke County,GA,2980,2573,-407
39101,Marion County,OH,6300,5892,-408
39137,Putnam County,OH,2854,2446,-408
02261,Valdez-Cordova Census Area,AK,1104,695,-409
36017,Chenango County,NY,5546,5136,-410
39023,Clark County,OH,14819,14406,-413
36043,Herkimer County,NY,6672,6255,-417
36073,Orleans County,NY,5169,4751,-418
18027,Daviess County,IN,2547,2128,-419
18135,Randolph County,IN,3384,2964,-420
19065,Fayette County,IA,2055,1632,-423
12039,Gadsden County,FL,6677,6253,-424
20035,Cowley County,KS,3129,2705,-424
48219,Hockley County,TX,2743,2317,-426
18177,Wayne County,IN,5221,4794,-427
37015,Bertie County,NC,1737,1309,-428
17095,Knox County,IL,4211,3780,-431
48489,Willacy County,TX,1737,1305,-432
05149,Yell County,AR,2537,2103,-434
40115,Ottawa County,OK,3807,3372,-435
42059,Greene County,PA,3098,2662,-436
55019,Clark County,WI,4004,3568,-436
28047,Harrison County,MS,32017,31579,-438
22007,Assumption Parish,LA,2866,2428,-438
22067,Morehouse Parish,LA,2314,1875,-439
40009,Beckham County,OK,2232,1792,-440
40153,Woodward County,OK,1405,965,-440
30041,Hill County,MT,1459,1018,-441
20099,Labette County,KS,1791,1345,-446
36009,Cattaraugus County,NY,7878,7431,-447
21107,Hopkins County,KY,3405,2956,-449
37127,Nash County,NC,15759,15310,-449
27147,Steele County,MN,4704,4255,-449
21071,Floyd County,KY,2757,2307,-450
01119,Sumter County,AL,922,471,-451
35017,Grant County,NM,2152,1700,-452
48057,Calhoun County,TX,2421,1969,-452
35053,Socorro County,NM,1492,1039,-453
40137,Stephens County,OK,3897,3441,-456
46065,Hughes County,SD,1974,1516,-458
54059,Mingo County,WV,1517,1058,-459
21193,Perry County,KY,1704,1242,-462
18083,Knox County,IN,3159,2695,-464
55005,Barron County,WI,5475,5010,-465
51630,Fredericksburg city,VA,12600,12135,-465
19057,Des Moines County,IA,3288,2821,-467
48025,Bee County,TX,3178,2711,-467
20057,Ford County,KS,2139,1671,-468
17029,Coles County,IL,5348,4879,-469
37163,Sampson County,NC,7868,7398,-470
31019,Buffalo County,NE,5692,5221,-471
12049,Hardee County,FL,3001,2529,-472
18169,Wabash County,IN,3359,2886,-473
18003,Allen County,IN,36665,36189,-476
40123,Pontotoc County,OK,4299,3820,-479
28143,Tunica County,MS,2138,1658,-480
16047,Gooding County,ID,2260,1779,-481
31151,Saline County,NE,1812,1329,-483
05027,Columbia County,AR,1637,1154,-483
51027,Buchanan County,VA,1224,738,-486
30063,Missoula County,MT,18151,17664,-487
28001,Adams County,MS,2204,1715,-489
48203,Harrison County,TX,11121,10630,-491
47183,Weakley County,TN,3458,2962,-496
46013,Brown County,SD,3006,2509,-497
37047,Columbus County,NC,4500,4001,-499
28051,Holmes County,MS,1707,1206,-501
18005,Bartholomew County,IN,10612,10110,-502
12091,Okaloosa County,FL,44877,44375,-502
26025,Calhoun County,MI,15136,14632,-504
39145,Scioto County,OH,4251,3746,-505
39037,Darke County,OH,5189,4684,-505
37023,Burke County,NC,10055,9546,-509
39075,Holmes County,OH,4147,3635,-512
28113,Pike County,MS,3455,2942,-513
39149,Shelby County,OH,5910,5396,-514
51199,York County,VA,16691,16176,-515
48227,Howard County,TX,2845,2326,-519
42131,Wyoming County,PA,4369,3848,-521
17109,McDonough County,IL,2532,2009,-523
26103,Marquette County,MI,3758,3234,-524
35029,Luna County,NM,2009,1483,-526
40015,Caddo County,OK,3457,2931,-526
22119,Webster Parish,LA,4572,4045,-527
46027,Clay County,SD,1849,1318,-531
27131,Rice County,MN,9345,8813,-532
19167,Sioux County,IA,2037,1504,-533
22009,Avoyelles Parish,LA,2753,2217,-536
01025,Clarke County,AL,2057,1521,-536
05145,White County,AR,8366,7829,-537
54045,Logan County,WV,1980,1443,-537
01095,Marshall County,AL,11503,10964,-539
56013,Fremont County,WY,2143,1604,-539
01005,Barbour County,AL,2227,1682,-545
45067,Marion County,SC,3130,2584,-546
31001,Adams County,NE,3289,2742,-547
31157,Scotts Bluff County,NE,2403,1853,-550
54033,Harrison County,WV,6189,5635,-554
40143,Tulsa County,OK,99844,99288,-556
40121,Pittsburg County,OK,3772,3212,-560
08097,Pitkin County,CO,3380,2819,-561
13009,Baldwin County,GA,4380,3819,-561
18071,Jackson County,IN,5640,5077,-563
21093,Hardin County,KY,17031,16467,-564
48449,Titus County,TX,3315,2747,-568
02150,Kodiak Island Borough,AK,1189,618,-571
31053,Dodge County,NE,4828,4252,-576
16011,Bingham County,ID,5937,5358,-579
22047,Iberville Parish,LA,4909,4329,-580
40021,Cherokee County,OK,5863,5273,-590
01087,Macon County,AL,2577,1986,-591
27119,Polk County,MN,4175,3584,-591
20175,Seward County,KS,2039,1447,-592
45077,Pickens County,SC,18054,17460,-594
31037,Colfax County,NE,1526,928,-598
18087,LaGrange County,IN,5289,4687,-602
53001,Adams County,WA,2501,1895,-606
28123,Scott County,MS,3228,2620,-608
20169,Saline County,KS,5747,5135,-612
45011,Barnwell County,SC,2231,1615,-616
02050,Bethel Census Area,AK,1402,786,-616
01077,Lauderdale County,AL,9139,8522,-617
37153,Richmond County,NC,3453,2833,-620
39169,Wayne County,OH,12931,12306,-625
19139,Muscatine County,IA,4862,4235,-627
01059,Franklin County,AL,3531,2903,-628
17197,Will County,IL,125595,124966,-629
42011,Berks County,PA,44634,44005,-629
27007,Beltrami County,MN,4727,4091,-636
19187,Webster County,IA,2956,2319,-637
39007,Ashtabula County,OH,8766,8128,-638
19033,Cerro Gordo County,IA,4248,3609,-639
54047,McDowell County,WV,1175,535,-640
45089,Williamsburg County,SC,3863,3216,-647
27099,Mower County,MN,4089,3442,-647
48117,Deaf Smith County,TX,1876,1226,-650
13039,Camden County,GA,7734,7084,-650
20009,Barton County,KS,1806,1151,-655
29051,Cole County,MO,10637,9978,-659
22075,Plaquemines Parish,LA,3889,3229,-660
21227,Warren County,KY,14106,13434,-672
29159,Pettis County,MO,4715,4041,-674
31111,Lincoln County,NE,2383,1709,-674
39147,Seneca County,OH,7522,6847,-675
51195,Wise County,VA,3180,2504,-676
01109,Pike County,AL,3347,2670,-677
35035,Otero County,NM,8176,7496,-680
35005,Chaves County,NM,4650,3966,-684
51830,Williamsburg city,VA,4444,3757,-687
42081,Lycoming County,PA,8796,8102,-694
35041,Roosevelt County,NM,2297,1600,-697
51740,Portsmouth city,VA,26929,26229,-700
48143,Erath County,TX,5237,4528,-709
29161,Phelps County,MO,4808,4095,-713
48361,Orange County,TX,11253,10535,-718
18017,Cass County,IN,4459,3740,-719
19021,Buena Vista County,IA,1666,942,-724
48377,Presidio County,TX,1145,420,-725
36057,Montgomery County,NY,7371,6646,-725
18039,Elkhart County,IN,22283,21550,-733
28011,Bolivar County,MS,3095,2361,-734
05019,Clark County,AR,2268,1530,-738
05107,Phillips County,AR,1262,524,-738
21195,Pike County,KY,3156,2412,-744
48321,Matagorda County,TX,4181,3435,-746
05035,Crittenden County,AR,5912,5166,-746
46011,Brookings County,SD,3510,2759,-751
20125,Montgomery County,KS,2976,2222,-754
29069,Dunklin County,MO,3268,2514,-754
35039,Rio Arriba County,NM,4635,3878,-757
05139,Union County,AR,2528,1764,-764
40065,Jackson County,OK,2217,1448,-769
29169,Pulaski County,MO,10164,9392,-772
26017,Bay County,MI,12057,11283,-774
37171,Surry County,NC,6704,5928,-776
27105,Nobles County,MN,1681,902,-779
45043,Georgetown County,SC,8567,7784,-783
56039,Teton County,WY,2603,1817,-786
36101,Steuben County,NY,8771,7982,-789
54069,Ohio County,WV,5544,4753,-791
16039,Elmore County,ID,3477,2686,-791
56005,Campbell County,WY,4412,3617,-795
48465,Val Verde County,TX,4090,3293,-797
28027,Coahoma County,MS,2132,1329,-803
35047,San Miguel County,NM,2776,1971,-805
51600,Fairfax city,VA,9775,8964,-811
42063,Indiana County,PA,7148,6328,-820
40071,Kay County,OK,4545,3725,-820
29147,Nodaway County,MO,1555,731,-824
55139,Winnebago County,WI,31311,30486,-825
20051,Ellis County,KS,2521,1695,-826
06107,Tulare County,CA,36893,36064,-829
51840,Winchester city,VA,9214,8385,-829
31047,Dawson County,NE,2539,1707,-832
48469,Victoria County,TX,11782,10948,-834
36075,Oswego County,NY,12347,11511,-836
37165,Scotland County,NC,3966,3129,-837
26061,Houghton County,MI,1810,970,-840
05123,St. Francis County,AR,2959,2114,-845
13031,Bulloch County,GA,9965,9120,-845
55043,Grant County,WI,5882,5036,-846
36063,Niagara County,NY,21531,20676,-855
20037,Crawford County,KS,4111,3250,-861
01045,Dale County,AL,10599,9737,-862
06031,Kings County,CA,18398,17529,-869
48341,Moore County,TX,2563,1694,-869
51590,Danville city,VA,6083,5207,-876
51153,Prince William County,VA,122923,122045,-878
28133,Sunflower County,MS,2825,1946,-879
39077,Huron County,OH,9105,8224,-881
28083,Leflore County,MS,2667,1785,-882
13261,Sumter County,GA,2337,1445,-892
55097,Portage County,WI,9097,8203,-894
41059,Umatilla County,OR,7805,6904,-901
54061,Monongalia County,WV,11780,10878,-902
48409,San Patricio County,TX,13566,12657,-909
39029,Columbiana County,OH,10568,9659,-909
19179,Wapello County,IA,3299,2387,-912
29213,Taney County,MO,6964,6048,-916
31119,Madison County,NE,4711,3790,-921
48249,Jim Wells County,TX,5848,4918,-930
26021,Berrien County,MI,17742,16799,-943
01103,Morgan County,AL,13784,12839,-945
37083,Halifax County,NC,4854,3903,-951
18089,Lake County,IN,67513,66562,-951
28149,Warren County,MS,3577,2623,-954
39173,Wood County,OH,25013,24053,-960
48005,Angelina County,TX,8988,8026,-962
27083,Lyon County,MN,2529,1561,-968
42077,Lehigh County,PA,63829,62860,-969
54011,Cabell County,WV,11216,10246,-970
48189,Hale County,TX,3797,2822,-975
23003,Aroostook County,ME,3428,2449,-979
22097,St. Landry Parish,LA,11217,10228,-989
42051,Fayette County,PA,10763,9756,-1007
45047,Greenwood County,SC,7295,6284,-1011
39155,Trumbull County,OH,21149,20133,-1016
30013,Cascade County,MT,8203,7182,-1021
39157,Tuscarawas County,OH,9219,8196,-1023
08037,Eagle County,CO,9751,8718,-1033
27067,Kandiyohi County,MN,4472,3433,-1039
27169,Winona County,MN,5558,4515,-1043
31043,Dakota County,NE,3687,2628,-1059
48303,Lubbock County,TX,40170,39101,-1069
18163,Vanderburgh County,IN,22509,21428,-1081
40101,Muskogee County,OK,8249,7168,-1081
35013,Dona Ana County,NM,14574,13478,-1096
17183,Vermilion County,IL,5506,4402,-1104
36089,St. Lawrence County,NY,4918,3812,-1106
40039,Custer County,OK,4107,2998,-1109
22069,Natchitoches Parish,LA,3859,2747,-1112
37107,Lenoir County,NC,7372,6248,-1124
36013,Chautauqua County,NY,7198,6069,-1129
28105,Oktibbeha County,MS,5774,4632,-1142
28075,Lauderdale County,MS,6079,4933,-1146
18053,Grant County,IN,5925,4776,-1149
19127,Marshall County,IA,4066,2912,-1154
22095,St. John the Baptist Parish,LA,8001,6841,-1160
16005,Bannock County,ID,9588,8421,-1167
37191,Wayne County,NC,13010,11841,-1169
08117,Summit County,CO,7024,5832,-1192
48273,Kleberg County,TX,4918,3722,-1196
39151,Stark County,OH,39322,38126,-1196
42021,Cambria County,PA,9507,8308,-1199
56037,Sweetwater County,WY,4286,3070,-1216
48323,Maverick County,TX,3994,2760,-1234
31079,Hall County,NE,7688,6453,-1235
16057,Latah County,ID,6131,4875,-1256
20155,Reno County,KS,5818,4536,-1282
17167,Sangamon County,IL,19684,18400,-1284
13313,Whitfield County,GA,10761,9465,-1296
55063,La Crosse County,WI,14421,13108,-1313
39133,Portage County,OH,30088,28773,-1315
40047,Garfield County,OK,6437,5118,-1319
05115,Pope County,AR,6989,5648,-1341
46079,Lake County,SD,2199,851,-1348
51730,Petersburg city,VA,10571,9220,-1351
48427,Starr County,TX,4162,2805,-1357
05093,Mississippi County,AR,4212,2851,-1361
55141,Wood County,WI,9350,7954,-1396
20111,Lyon County,KS,3202,1805,-1397
47155,Sevier County,TN,13113,11688,-1425
37065,Edgecombe County,NC,9470,8029,-1441
10003,New Castle County,DE,75224,73773,-1451
06019,Fresno County,CA,85434,83969,-1465
17119,Madison County,IL,31002,29533,-1469
39009,Athens County,OH,6216,4727,-1489
05131,Sebastian County,AR,18383,16874,-1509
22079,Rapides Parish,LA,12695,11181,-1514
55035,Eau Claire County,WI,18296,16773,-1523
39017,Butler County,OH,63103,61571,-1532
04023,Santa Cruz County,AZ,6457,4924,-1533
39003,Allen County,OH,10575,9032,-1543
37189,Watauga County,NC,6578,5033,-1545
22071,Orleans Parish,LA,80702,79154,-1548
29021,Buchanan County,MO,10685,9132,-1553
45041,Florence County,SC,15891,14320,-1571
04027,Yuma County,AZ,21786,20185,-1601
35009,Curry County,NM,6632,5029,-1603
22019,Calcasieu Parish,LA,20693,19071,-1622
48471,Walker County,TX,12905,11278,-1627
56001,Albany County,WY,6206,4565,-1641
29077,Greene County,MO,47460,45818,-1642
26073,Isabella County,MI,10237,8593,-1644
29101,Johnson County,MO,8393,6747,-1646
28151,Washington County,MS,3994,2339,-1655
22061,Lincoln Parish,LA,6043,4386,-1657
23019,Penobscot County,ME,16765,15104,-1661
28035,Forrest County,MS,16848,15177,-1671
01125,Tuscaloosa County,AL,20475,18796,-1679
38101,Ward County,ND,9395,7713,-1682
13053,Chattahoochee County,GA,4231,2534,-1697
17115,Macon County,IL,8607,6905,-1702
49035,Salt Lake County,UT,173109,171368,-1741
06087,Santa Cruz County,CA,45476,43710,-1766
18167,Vigo County,IN,11193,9387,-1806
49049,Utah County,UT,85774,83912,-1862
51770,Roanoke city,VA,22939,21074,-1865
35013,Doña Ana County,NM,10322,8444,-1878
19193,Woodbury County,IA,10933,9029,-1904
20045,Douglas County,KS,19788,17858,-1930
01047,Dallas County,AL,3891,1959,-1932
22115,Vernon Parish,LA,10444,8510,-1934
22045,Iberia Parish,LA,9885,7946,-1939
22101,St. Mary Parish,LA,6192,4246,-1946
22109,Terrebonne Parish,LA,12991,11039,-1952
27013,Blue Earth County,MN,13888,11935,-1953
27109,Olmsted County,MN,20679,18716,-1963
35031,McKinley County,NM,14766,12786,-1980
01015,Calhoun County,AL,12454,10472,-1982
13185,Lowndes County,GA,16608,14625,-1983
48347,Nacogdoches County,TX,8749,6753,-1996
39099,Mahoning County,OH,26022,24001,-2021
27137,St. Louis County,MN,21465,19418,-2047
45075,Orangeburg County,SC,10030,7913,-2117
26081,Kent County,MI,95979,93824,-2155
37155,Robeson County,NC,10632,8458,-2174
06025,Imperial County,CA,17799,15571,-2228
37049,Craven County,NC,15987,13706,-2281
22073,Ouachita Parish,LA,16328,14021,-2307
48451,Tom Green County,TX,16775,14450,-2325
54039,Kanawha County,WV,17580,15250,-2330
17077,Jackson County,IL,8481,6142,-2339
38035,Grand Forks County,ND,10714,8360,-2354
18141,St. Joseph County,IN,32893,30518,-2375
36065,Oneida County,NY,18669,16276,-2393
25015,Hampshire County,MA,28965,26558,-2407
51660,Harrisonburg city,VA,9779,7355,-2424
31109,Lancaster County,NE,33535,31094,-2441
45085,Sumter County,SC,11848,9374,-2474
34011,Cumberland County,NJ,14130,11648,-2482
18035,Delaware County,IN,13198,10715,-2483
20177,Shawnee County,KS,17848,15350,-2498
37061,Duplin County,NC,8915,6413,-2502
37147,Pitt County,NC,23837,21330,-2507
53075,Whitman County,WA,8759,6251,-2508
48441,Taylor County,TX,20480,17926,-2554
36007,Broome County,NY,17233,14583,-2650
45079,Richland County,SC,86576,83916,-2660
48183,Gregg County,TX,25758,23074,-2684
17113,McLean County,IL,20870,18179,-2691
26077,Kalamazoo County,MI,38255,35524,-2731
13067,Cobb County,GA,219876,217133,-2743
51680,Lynchburg city,VA,15309,12561,-2748
34035,Somerset County,NJ,78504,75735,-2769
17201,Winnebago County,IL,31039,28247,-2792
20209,Wyandotte County,KS,34347,31469,-2878
40109,Oklahoma County,OK,134744,131865,-2879
19013,Black Hawk County,IA,14276,11396,-2880
12087,Monroe County,FL,16867,13969,-2898
06113,Yolo County,CA,44850,41946,-2904
27145,Stearns County,MN,29908,26990,-2918
17161,Rock Island County,IL,18029,15109,-2920
40119,Payne County,OK,12314,9339,-2975
04003,Cochise County,AZ,19158,16158,-3000
13179,Liberty County,GA,20937,17928,-3009
25027,Worcester County,MA,105845,102822,-3023
42027,Centre County,PA,14442,11382,-3060
48485,Wichita County,TX,15790,12684,-3106
50007,Chittenden County,VT,26872,23764,-3108
42045,Delaware County,PA,95308,92070,-3238
51650,Hampton city,VA,40385,37107,-3278
51121,Montgomery County,VA,12392,9101,-3291
13095,Dougherty County,GA,14751,11367,-3384
42043,Dauphin County,PA,47726,44281,-3445
51540,Charlottesville city,VA,15387,11936,-3451
12095,Orange County,FL,372430,368976,-3454
37081,Guilford County,NC,88924,85454,-3470
05069,Jefferson County,AR,8712,5127,-3585
34001,Atlantic County,NJ,34134,30538,-3596
40031,Comanche County,OK,19532,15915,-3617
13021,Bibb County,GA,23358,19720,-3638
37133,Onslow County,NC,51554,47869,-3685
26145,Saginaw County,MI,22178,18486,-3692
36109,Tompkins County,NY,15203,11497,-3706
31055,Douglas County,NE,87382,83672,-3710
29019,Boone County,MO,25537,21760,-3777
53077,Yakima County,WA,22158,18374,-3784
39057,Greene County,OH,35831,32023,-3808
49005,Cache County,UT,17494,13662,-3832
13059,Clarke County,GA,25341,21498,-3843
12005,Bay County,FL,28070,24225,-3845
13051,Chatham County,GA,55683,51780,-3903
48375,Potter County,TX,29093,25061,-4032
51760,Richmond city,VA,79659,75577,-4082
39153,Summit County,OH,80567,76387,-4180
34025,Monmouth County,NJ,103483,99266,-4217
36071,Orange County,NY,58484,54253,-4231
20061,Geary County,KS,15611,11358,-4253
37135,Orange County,NC,36697,32429,-4268
36045,Jefferson County,NY,21810,17535,-4275
41003,Benton County,OR,21204,16920,-4284
02090,Fairbanks North Star Borough,AK,17058,12741,-4317
25009,Essex County,MA,122767,118395,-4372
19169,Story County,IA,15130,10735,-4395
17163,St. Clair County,IL,34596,30164,-4432
18157,Tippecanoe County,IN,25938,21429,-4509
20161,Riley County,KS,17292,12733,-4559
06007,Butte County,CA,33948,29367,-4581
09011,New London County,CT,41053,36452,-4601
04005,Coconino County,AZ,29131,24506,-4625
06111,Ventura County,CA,120723,116059,-4664
16065,Madison County,ID,9885,5207,-4678
19103,Johnson County,IA,25412,20708,-4704
48479,Webb County,TX,15121,10403,-4718
08013,Boulder County,CO,85984,81249,-4735
51510,Alexandria city,VA,91609,86867,-4742
21047,Christian County,KY,17334,12584,-4750
01097,Mobile County,AL,33169,28324,-4845
34007,Camden County,NJ,90369,85490,-4879
17143,Peoria County,IL,27789,22889,-4900
29095,Jackson County,MO,130138,125217,-4921
13215,Muscogee County,GA,46374,41434,-4940
34027,Morris County,NJ,100094,95122,-4972
42049,Erie County,PA,17218,12180,-5038
20173,Sedgwick County,KS,52900,47827,-5073
05119,Pulaski County,AR,63912,58828,-5084
51700,Newport News city,VA,53267,48136,-5131
26049,Genesee County,MI,48819,43588,-5231
12033,Escambia County,FL,59597,54329,-5268
36001,Albany County,NY,63331,57947,-5384
18105,Monroe County,IN,22087,16441,-5646
48355,Nueces County,TX,50296,44650,-5646
35045,San Juan County,NM,18961,13121,-5840
36085,Richmond County,NY,64393,58443,-5950
01101,Montgomery County,AL,33818,27614,-6204
48041,Brazos County,TX,36920,30570,-6350
55025,Dane County,WI,92956,86602,-6354
13089,DeKalb County,GA,280494,273590,-6904
47037,Davidson County,TN,188671,181764,-6907
48245,Jefferson County,TX,35746,28801,-6945
48215,Hidalgo County,TX,44274,37267,-7007
13245,Richmond County,GA,44206,37117,-7089
35001,Bernalillo County,NM,98743,91651,-7092
39095,Lucas County,OH,50050,42858,-7192
39113,Montgomery County,OH,80730,73448,-7282
25021,Norfolk County,MA,181930,174547,-7383
22017,Caddo Parish,LA,38199,30794,-7405
36087,Rockland County,NY,40182,32738,-7444
17019,Champaign County,IL,29072,21587,-7485
21067,Fayette County,KY,54797,47291,-7506
06083,Santa Barbara County,CA,62568,54854,-7714
48061,Cameron County,TX,31423,23699,-7724
51810,Virginia Beach city,VA,120107,112111,-7996
25013,Hampden County,MA,47513,39515,-7998
22051,Jefferson Parish,LA,79085,70986,-8099
34021,Mercer County,NJ,67269,59082,-8187
24005,Baltimore County,MD,186007,177553,-8454
34039,Union County,NJ,114673,106148,-8525
26065,Ingham County,MI,60133,51335,-8798
06001,Alameda County,CA,381632,372268,-9364
06053,Monterey County,CA,62737,53166,-9571
36067,Onondaga County,NY,53379,43661,-9718
21111,Jefferson County,KY,105681,95604,-10077
12001,Alachua County,FL,57329,47062,-10267
37051,Cumberland County,NC,90633,80134,-10499
51710,Norfolk city,VA,80859,70334,-10525
12073,Leon County,FL,60816,50286,-10530
01073,Jefferson County,AL,94707,83893,-10814
28049,Hinds County,MS,41890,31045,-10845
26161,Washtenaw County,MI,84428,72381,-12047
39049,Franklin County,OH,237354,225282,-12072
36029,Erie County,NY,79079,66833,-12246
44007,Providence County,RI,96632,84249,-12383
34003,Bergen County,NJ,177267,164701,-12566
02020,Anchorage Municipality,AK,59683,45702,-13981
22033,East Baton Rouge Parish,LA,75233,61059,-14174
27123,Ramsey County,MN,159801,145316,-14485
29510,St. Louis city,MO,108716,93418,-15298
26125,Oakland County,MI,256600,241202,-15398
17097,Lake County,IL,125647,110087,-15560
29189,St. Louis County,MO,197679,182105,-15574
36119,Westchester County,NY,176190,160613,-15577
36055,Monroe County,NY,80768,65036,-15732
34031,Passaic County,NJ,92015,76143,-15872
27053,Hennepin County,MN,301781,285753,-16028
06081,San Mateo County,CA,199032,182859,-16173
11001,District of Columbia,DC,242913,226210,-16703
09009,New Haven County,CT,132349,115056,-17293
48141,El Paso County,TX,103699,85473,-18226
06073,San Diego County,CA,541208,522947,-18261
34013,Essex County,NJ,163806,144846,-18960
24033,Prince George's County,MD,224778,205630,-19148
39061,Hamilton County,OH,139853,120604,-19249
09001,Fairfield County,CT,156070,135836,-20234
18097,Marion County,IN,198275,177100,-21175
42003,Allegheny County,PA,171196,149762,-21434
47157,Shelby County,TN,122007,100509,-21498
51013,Arlington County,VA,137385,115035,-22350
09003,Hartford County,CT,137799,115121,-22678
15003,Honolulu County,HI,164182,139423,-24759
34017,Hudson County,NJ,216600,191447,-25153
36103,Suffolk County,NY,191147,165734,-25413
17043,DuPage County,IL,224452,198849,-25603
24510,Baltimore city,MD,169658,143401,-26257
48201,Harris County,TX,715337,687316,-28021
48113,Dallas County,TX,587429,558983,-28446
36059,Nassau County,NY,229947,201051,-28896
34023,Middlesex County,NJ,188628,159458,-29170
39035,Cuyahoga County,OH,174858,145207,-29651
06075,San Francisco County,CA,310562,279441,-31121
24031,Montgomery County,MD,243631,211447,-32184
55079,Milwaukee County,WI,150644,117701,-32943
42101,Philadelphia County,PA,287049,249547,-37502
25017,Middlesex County,MA,383646,343762,-39884
06059,Orange County,CA,521898,480518,-41380
26163,Wayne County,MI,264739,223031,-41708
51059,Fairfax County,VA,351902,302403,-49499
25025,Suffolk County,MA,293248,239907,-53341
06085,Santa Clara County,CA,383796,319328,-64468
36005,Bronx County,NY,288735,217822,-70913
36047,Kings County,NY,597725,488370,-109355
36081,Queens County,NY,495108,385454,-109654
36061,New York County,NY,692554,563526,-129028
12086,Miami-Dade County,FL,494332,349421,-144911
17031,Cook County,IL,814767,629294,-185473
06037,Los Angeles County,CA,1260796,1017811,-242985
